English	Gloss
stands up and looks inside something	cl.d(5d):frasco cl.e(Hd):RANA-en-frasco cl.e(C):FRASCO
A pig is building what? a house how do he does that? with bundles of straw.	UNO CERDO SECCIÓN(1M) ARREGLAR OBJETIVO CUÁL CASA CÓMO LIGERO MADERA PALO
The wolf moves back.	LOBO cl.c(1):PATAS-retroceder
the dog stealthily	cl.e(5d):PIEDRA cl.e(1):PERSONA-ascender+a-piedra
The boy climbs on the rock	cl.e(2d):PERRO-en-localización cl.e(Bh):LOCALIZACIÓN PERRO B:cl.e(Bh):LOCALIZACIÓN cl.e(2d):PERRO-rodar-localización B:cl.e(Bh):LOCALIZACIÓN
The petals closed.	G:persona-encogerse
(Continues riding) the bike	BICICLETA
The deer runs (furiously)	cl.c(A):patas-correr CIERVO
The (wolf) moves back.	INDX CONTINUAR
(and) saw (the boy on the ground)	MIRAR
and there was a ray of light in the forest and	BOSQUE cl.d(5):nubes-abrirse
And a dog whose sign is this	PERRO SN:perro
He climbs up the ladder	cl.e(2d):PERSONA-ascender-árbol cl.e(5):ÁRBOL
(since) the bottle (it was in) had no lid on it	CRISTAL2 cl.d(B):forma-frasco cl.m(5d):abrir-tapa B:cl.d(B):forma-frasco NADA(1M) B:cl.d(B):forma-frasco
(hitting) a ball	B:cl.m(Xc):sostener-raqueta cl.e(O):PELOTA
"Oh!" Amazing! The two our frog and another they are a couple are wedded.	INDX B:cl.m(Bd):apoyarse-en+tronco MENTE-APAGADA(1M) B:cl.m(Bd):apoyarse-en+tronco LOS-DOS B::cl.m(Bd):apoyarse-en+tronco SN:RANA LOS-DOS PAREJA NOVIO
Tell you a past story?	INFORMAR PASADO(2Msu) HISTORIA
How beautiful!"	INDX cl.m(5d):apoyarse-en+tronco BONITO2
They followed the footprints	cl.c(I):PIE-pisar cl.e(1):PERSONAS-desplazarse
and screams: "Child [his sign]"	GRITAR2 SN:niño
He gets off the bike (and)	cl.e(Xa):BICICLETA cl.e(2d):PERSONA-descender+de-bicicleta cl.e(Bh):BICICLETA
He put the pears in the baskets.	cl.m(Cc&amp;gt;5d):echar-fruta
"One basket of pears has disappeared	DESAPARECER UNO cl.d(B):cesta PERA4
(and) the basket too	CESTO cl.e(A):CESTO-caer
(as) he walks with the other two boys.	cl.e(2):PERSONAS2-desplazarse
The (blond boy) gives a pear for each one.	INDX REGALAR PERA4 UNO UNO
had disappeared. "It can't be" he said.	DESAPARECER PODER3 B:DESAPARECER
I do not recognise this (she thought)	CONOCER NO
(are) the same ones as before	MISMO LO-DE-ANTES
(He lacks) proof	SUSTANCIA
They had seen him	MIRAR
and plucks a pear	cl.m(5d):coger-fruta cl.e(C):SACO
Climbs down	cl.e(2d):PERSONA-descender-árbol B:cl.e(5):ÁRBOL
It hesitates but stays on his hand	cl.e(2b):PERSONA-sobre-ciervo cl.e(Hd):CIERVO-correr cl.d(5d):talud cl.d(2d):talud cl.e(2b):PERSONA-sobre-ciervo cl.e(Hd):CIERVO-correr
The boy extends his hand	cl.c(A):pezuñas-correr
"How strange!" he thought "this can’t be true." 	MENTE-APAGADA RARO
approaching	cl.e(3):PERSONAS3-aproximarse B:cl.c(1):PIERNA
Incredible (they have had) many offspring	SORPRESA NACER cl.e(5):RANAS-fila MENTE-APAGADA
The boy looks at the trunk	HOMBRE B:cl.e(5):ÁRBOL cl.e(5d):PIEDRA B:cl.e(5):ÁRBOL B:cl.e(5d):PIEDRA cl.e(2d):PERSONA-ascender+a-piedra
"I want to ask you the wizard...	INDX.PRO:1sg LLAMAR BRUJO G
went out	cl.e(2d):PERSONA-salir-tienda cl.e(Bd):TIENDA
I'm going to give it to you	DAR(L)(2M)
and he whistled to the boy.	INDX.PRO SILBAR
The wolf approaches quietly	INDX LOBO cl.c(1):PATAS-andar
Lifted the animal in his arms	cl.m(Bd):coger-perro
sees [something] (at the top)	MIRAR
He climbs down the tree	AHORA cl.e(2d):PERSONA-descender+de-árbol B:cl.e(5):ÁRBOL
The dog is on all fours	HOMBRE PEQUEÑO2 BUSCAR(2Msu)
Next to the frog	MIRAR
The dog (follows them in parallel) barking:	PERRO GRITAR2
What did the three do?	LOS-TRES
is a row of frogs	B:MIRAR ASUSTAR(2M)
by the wolf.	MOTIVO LOBO SOPLAR
The child [his sign] sees them	INDX HOMBRE SN:niño MIRAR
I think waiting is good" thought Kuma.	PENSAR(2Msu) BIEN(2M) ESPERAR2(2M)
"I'm going to go to consult the wizard."	INDX.PRO:1sg MENTE IR CASA BRUJO G
"I want one of these pears from the basket" (he thought).	INDX B:ÁRBOL QUERER B:ÁRBOL INDX B:ÁRBOL PERA2 B:ÁRBOL INDX B:ÁRBOL G:¿cómo-puedo-hacer? B:ÁRBOL
(Arua) walked	CAMINAR(MP)
And just then...	CASUAL
(and a) girl on a bike meet	MUJER cl.e(Xa):BICICLETA cl.e(Xa):BICICLETA-aproximarse-bicicleta BICICLETA cl.e(Xa):BICICLETA-aproximarse-bicicleta
The two brothers (stay) silent: "Aha	LOS-DOS HERMANO SILENCIO MIRA-TÚ
and the dog meanwhile was walking through the forest.	SN:PERRO MIENTRAS cl.e(Hd):PERRO-desplazarse+de-suelo cl.e(Bh):SUELO
"Frog where are you?"	RANA SN:rana DÓNDE
"How [can this be possible]?	CÓMO
Can we start?	EMPEZAR
They woke up with the frog in mind	DESPERTAR MENTE^OBJETIVO SN:RANA B:MENTE^OBJETIVO
the house is safe."	TRES YA VER TRANQUILO G
The boy sees the hive	BUSCAR(2Msu)
He looked back at the man.	MIRAR B:ÁRBOL
The boy from above: "Don't make noise"	cl.e(1):PERSONA-correr
and the owl pursues him	cl.d(A&amp;gt;5h):frasco-estallar
	MIRAR(2M)
and sees something down	cl.e(1):PERSONA-desplazarse-con+perro cl.e(2d):PERRO-desplazarse-con+persona
the child falls to the ground	cl.e(2d):PERSONA-caer
The brother is surprised: Oh!	HOMBRE- (CNM)
at a certain distance the dog also runs	HOMBRE MIRAR(MP)
(The two pigs desperately) run	G(5):desesperación CORRER(5)
(when) another girl also on a bike approached	MUJER OTRO MUJER PEQUEÑO2 TAMBIÉN BICICLETA cl.e(Bl):BICICLETA-aproximarse-bicicleta
I('ll try) again" (thinks the wolf).	OTRA-VEZ
walking past him	cl.e(3):PERSONAS3-alejarse
approaches	cl.e(Bl):BICICLETA-aproximarse BICICLETA
that bounces back and forth;	B:cl.m(Xc):sostener-raqueta cl.e(O):PELOTA-botar
I’m going to tell (this story).	INDX.PRO:1sg EXPLICAR
This is why he fell	MOTIVO CAER
searching among the grass it discovered something	cl.m(5h):rebuscar-en+hierba INDX
"Dog [his sign] silence wait"	SN:perro SILENCIO ESPERAR2
all by himself	CONTINUAR G:a-su-manera
and was walking away (but)	ALEJARSE cl.m(5d):agarrar-rana G:cambio-de-parecer B:cl.m(5d):agarrar-rana
and the girl continued (as if nothing had happened)	AHORA INDX MUJER ALEJARSE
The two fall down	cl.e(Ap&amp;gt;2d):PERRO-caer+con-persona cl.e(Ap&amp;gt;2d):PERSONA-caer+con-perro
(She was) a little pretentious	IGUAL PRESUMIDO
and hits a stone	PIEDRA cl.e(Xa):BICICLETA-chocar-piedra cl.e(Xa):PIEDRA
picking pears	COGER PERA4(Xc)
It surely must be there	INDX ES.SEGURO
In the meantime the man who was up in the tree climbed down.	G:mmm OTRO HOMBRE cl.e(2d):PERSONA-ascender+a-árbol cl.e(5):ÁRBOL cl.e(2d):PERSONA-descender+de-árbol cl.e(5):ÁRBOL
"There is the house	VER CASA
They escape each running away on its own	ALEJARSE(2Msu)
Upon receiving the fruit the boy thanked him	cl.m(5d):agarrar-fruta GRACIAS(1M) B:cl.m(5d):agarrar-fruta
And a frog whose sign is this [sack-vowel-of-frog].	OTRO ANIMAL RANA SIGNO SN:RANA
"Hey the wolf is coming" (it thought).	VENIR B:cl.m(A):apoyarse-ventana LOBO(1M) B:cl.m(A):apoyarse-ventana INTENSO B:cl.m(A):apoyarse-ventana
In the meantime the man in the tree was oblivious to everything	HOMBRE B:cl.e(Bh):SUELO cl.e(1):PERSONA-localización B:cl.e(Bh):SUELO MENTE^NORMAL
(and) puts them in his apron pocket.	cl.d(C):bolsillo-delantal cl.m(5d&amp;gt;5):coger+guardar-fruta cl.d(C):bolsillo-delantal
(The one with the racquet) continues to play with the ball	CONTINUAR cl.m(Xc):accionar-raqueta cl.e(O):PELOTA-botar cl.m(Cc):sostener-raqueta CONTINUAR
(The boy is) angry	RABIA B:cl.m(C):sostener-perro
I will do it a second time.	OTRA-VEZ B.L(2) INDX:segundo
They approached the boy	cl.e(3):PERSONAS3-aproximarse
and the house is torn down.	cl.e:CASA-desintegrarse
Strolling along	PASEAR
and an apron	cl.d(Xa):tira-delantal
The (child is riding) a bike	INDX BICICLETA
"Silence"	SILENCIO ESPERAR2
The man (is) working picking pears	HOMBRE PERSONA TRABAJAR PERA4(Q)
No (it was the) other (boy): the boy on the bicycle.	NO OTRO2 HOMBRE BICICLETA
naked.	G:conmovido DESNUDO G:conmovido
"Brother	AVISAR
to think: "Weird"	PENSAR RARO G:pensar
This village was among lush mountains.	MONTAÑA BOSQUE PUEBLO cl.e(Xa):localización-pueblo
there is a hive in one of the trees	cl.m(C):colocar-frasco
because he was strong and brave.	FUERTE DEPORTE
and breaks into pieces	cl.d(A&amp;gt;5):frasco-desintegrarse
The boy goes with the dog	SN:niño cl.e(1):PERRO-desplazarse+con-persona cl.e(1):PERSONA-desplazarse+con-perro
There was a fallen tree	ÁRBOL EMPUJAR cl.e(1):ÁRBOL-caído cl.e(Bh):SUELO
He placed his hands	SN:NIÑO cl.m(5):apoyarse-en+tronco
"The three pigs and the wolf".	TÍTULO TRES CERDO OTRO UNO LOBO
I will let you know	RESPONDER
The boy gave him three pears in appreciation for having recovered his hat.	HOMBRE TRES LO-DE-ANTES COMPENSACIÓN GRACIAS SOMBRERO TRES PERA cl.m(5d):dar-fruta cl.m(5d):dar-fruta
looks (mischievously at the man)	MIRAR
(The wolf) moves back.	G:respirar cl.c(1):PATAS-retroceder
The (third brother): "Relax	INDX TRANQUILO
on his bike	cl.e(2b):PERSONA-ascender+a-bicicleta cl.e(1):BICICLETA
He was asleep and	G:dormido DORMIR G:dormir
The child thanked them	HOMBRE G SENTIR GRACIAS G
(The man) is plucking pears	B:cl.e(5d):PERAS-en-árbol cl.m(5d):coger-fruta cl.m(5d):guardar-fruta B:cl.m(5d):coger-fruta
The next day at sunrise	DÍA AMANECER
I will take care of the seven and this girl.	SIETE MÁS.SUMA INDX MUJER INDX CUIDAR
One of the (terrified) pigs look out the window.	INDX CERDO UNO VENTANA cl.m(A):apoyarse-ventana
"(What) does (Arua) want?	QUERER G:interrogativo
An animal comes out of the burrow and slams her face	cl.e(5d&amp;gt;Cc):ANIMAL-ascender-madriguera cl.e(C):MADRIGUERA
(The child) looks at him	MIRAR
The fruit falls	cl.d(5):peras-caer+colectivo
He calls out (to it)	GRITAR2
The father (was) behind them hiding and	PADRE cl.e(1):PERSONA-detrás-localización cl.e(1):LOCALIZACIÓN ESCONDER
Arua fell asleep inside the flower	DORMIRSE
"I will help you.	INDX.PRO:1sg AYUDAR
They began to put back all the pears in the basket.	cl.m(5):echar-fruta PERA B:cl.m(5):echar-fruta cl.m(A&amp;gt;5):echar-fruta cl.m(5):echar-fruta cl.m(A&amp;gt;5d):echar-fruta-en+cesta cl.e(Xc):CESTA cl.m(5d):echar-fruta cl.m(A&amp;gt;5d):echar-fruta
working away	TRABAJAR
The dog sees a hive at the tree top	PERRO MIRAR ÁRBOL COLMENA
(The child) sees something (in the distance)	MIRAR
"It’s quite clear! You had adopted her	G:brujo G:evidencia INDX.PRO:2sg INDX.PRO:3sg cl.m(5d):coger-persona
I should not decide she should".	INDX.PRO:1sg SENTIR NO INDX.PRO
the boy continued pedalling spellbound	HOMBRE cl.m(A):agarrar-manillar BOBO B:cl.m(A):agarrar-manillar cl.m(A):agarrar-manillar
and the dog ran away.	SN:PERRO cl.c(B):garras-correr ALEJARSE
"Shhh! Wait"	SILENCIO ESPERAR2
(checks that the man is not looking at him)	B:cl.e(2b):PERSONA-ascender+a-bicicleta
They had seen the whole scene	MIRAR B:cl.c(1):PIERNA TODO PELÍCULA PASADO
I will give you shelter and take care of you.	INDX.PRO:2sg B CASA CUIDAR INDX.PRO:2sg
Just then three children come by	CASUAL INDX NIÑO HOMBRE TRES PEQUEÑO2 TRES cl.e(3):PERSONAS3-aproximarse
The wolf (stays) calm:	LOBO TRANQUILO
The house does not move	cl.e:CASA
(He pulls) up one sock	cl.d(B):calcetín-subido cl.c(B):pierna
"Do you have [another solution]?	HABER G:interrogativo
into the distance.	PERRO B:cl.e(Xa):ONDA-abrirse cl.e(2b):PERRO-caer-charco B:cl.e(Xa):ONDA-abrirse cl.d(5d):poza-agua
I've heard it	ESCUCHAR(2)
and when he was relaxed an animal emerged.	G:niño-relajarse cl.e(2b):PERSONA-sobre-entidad cl.e(1):ENTIDAD-ascender
The two (siblings) continue talking	LOS-DOS CÓMO CONTINUAR CONTACTO
(suddenly) the branches begin to move	cl.m(A):agarrar-ramas
and screams	GRITAR2
They will catch	COGER
into the distance.	ALEJARSE
The eldest son went again to Kuma	INDX.PRO:3sg OTRA-VEZ INDX.PRO:3sg HIJO MAYOR G:acercar-Kuma
is frightened	G(5)(2M):asustarse
It wants to eat the three pigs all three of them.	QUERER TRES CERDO COMER TODO QUERER G(B):vale
(The child) looks (on the floor)	MIRAR
takes the dog in his arms	cl.m(C):coger-perro
The dog also looks at the trunk	MIRAR
in the distance.	B:cl.c(A):pezuñas-caminar cl.e(1):localización-cabra
zig zagging along.	cl.e(Bl):BICICLETA-desplazarse-suelo cl.e(Bh):SUELO cl.e(Xa):BICICLETA-desplazarse-suelo B:cl.e(Bh):SUELO
(The man) looked at them	MIRAR
and playing (with the frog)	JUGAR
He woke up.	DESPERTAR
Stop it will be safe".	TRANQUILO ES.ASÍ(1M) B:TRANQUILO ES.SEGURO
harvesting	CONTINUAR
They continued on their way	CAMINAR(MP)
Are you happy for adopting her?"	INDX.PRO:2sg FELIZ cl.m(5d):coger-persona G:prosódico
When the seven looked at the flower	cl.e(2):PERSONAS7-girarse+mirar cl.e(5):PERSONAS7-girarse+mirar
to take a step	cl.c(B):pies-andar
with bees swarming	BUSCAR(2Msu)
"Hello" (says joker).	G:mímica-lobo SALUDO
The [other] boy receiving the pears said "Thank You"	HOMBRE cl.m(Bd)sostener-peras GRACIAS(1M) B:cl.m(Bd)sostener-peras G
The dog sniffs the jar	PERRO MIRAR- cl.e(2d):PERRO-entrar-frasco cl.e(B):FRASCO
The frog pulled itself out the mouth of the jar	INDX SN:RANA cl.e(2d):RANA-salir-frasco cl.e(C):FRASCO
The dog which was barking was likewise thrown	PERRO B:cl.e(Bh):CIERVO LADRAR B:cl.e(Bh):CIERVO cl.e(2d):PERRO-caer cl.e(Bh):CIERVO
Let me explain	INDX.PRO:1sg EXPLICAR
"It was the dog when it jumped out the window" (he said) and (also) jumped out.	cl.e(2d):PERRO-descender+de-ventana B:cl.e(B):VENTANA INDX B:cl.e(B):VENTANA cl.e(2d):PERRO-descender+de-ventana B:cl.e(B):VENTANA
The two men: "were right 	cl.e:HUMO-alejarse-localización cl.e(B):LOCALIZACIÓN
along the road	cl.e(Xa):BICICLETA-sobre-suelo cl.e(Bh):SUELO
Just like his father (the man on the tree)	IGUAL2 PADRE(2p) INDX.AUX cl.e(1):PERSONA
behind which were some branches.	hhh cl.d(1):ramas
"It is in this tree	ÁRBOL INDX
The wolf ignores (this)	cl.d(5d):olla-grande AGUA B:cl.d(5d):olla-grande cl.m(A):botella-echar-agua B:cl.d(5d):olla-grande LLENAR B:cl.d(5d):olla-grande
Incredible	MENTE-APAGADA
"I’m going to prepare myself wait".	AHORA PREPARAR(1M) AHORA cl.c(1):PATAS ESPERAR2 B:cl.c(1):PATAS
(Kuma) went to the wizard’s house again.	OTRA-VEZ IR CASA(M-AB) BRUJO
approaching	cl.c(A):pezuñas-caminar
(There are) three baskets.	cl.d(5):cesta cl.d(5):cesta cl.d(5):cesta TRES HABER
The blond boy (is) sitting:	HOMBRE RUBIO SENTAR
and she stopped again	OTRA-VEZ PARAR
the moon lit up over her.	cl.d(Lc&amp;gt;L&amp;gt;Lc):luna-forma LUZ
and then climbs down the tree	cl.e(2d):PERSONA-descender-árbol cl.e(5):ÁRBOL
because (the handlebar) was heavy.	IGUAL PESADO
they sting!	cl.e(Lc):AVISPA-chocar-brazo cl.c:brazo G(5):dolor
(and suddenly) a pear falls to the ground.	cl.e(1):TRAIECTORIA-caer
passed by with the leash in hand	cl.m(Xc):agarrar-corea
He put the basket (on the handlebar).	hhh PERA cl.m(Xc):colocar-cesta cl.m(Xc):colocar-cesta
(The wolf) is coming!"	AHORA VENIR
in short.	CORTO
I felt sorry for that child and	PENA PEQUEÑO2 G
"Look brother I won 	VER HERMANO PRIMERO B:HERMANO
What a disappointment	IRREVERSIBLE B:cl.e(C):FRASCO
where the deer stops suddenly.	cl.e(Lc):INSECTOS-volar
searches everywhere	BUSCAR(2Msu)
The seven headed (towards the flower).	cl.e(2):PERSONAS7-aproximarse cl.e(5):PERSONAS7-aproximarse
The dog is looking for it	INDX? SN:perro BUSCAR(2Msu)
And as they move away	ALEJARSE
(and when it was) full	cl.d(5):peras-superficie LISTO
Hello!	HOLA
Moreover (your) seven sons will miss (her) company	MÁS.SUMA HIJO SIETE NECESITAR(MP) AVAL
I have assigned him this sign.	SIGNO DAR(2M) SN:KUMA
not concerned about anything	MENTE^NORMAL
(There are) three pigs	TRES HERMANO- CERDO TRES
and screams within her	cl.e(C):MADRIGUERA
who falls from the tree to the ground	cl.e(2d):PERSONA-caer+de-tronco cl.e(5):TRONCO ACABAR
eating the fruit	cl.m(5d):agarrar+comer-fruta
The two houses of your two brothers his and mine have disappeared" (they say nervously).	HERMANO DOS INDX SEGUNDO PROPIO LOS-DOS HERMANO CASA DESAPARECER
searching	BUSCAR(2Msu)
still annoyed	RABIA B:cl.d(C):piedra-forma
was the village chief	UNO cl.e(1):PERSONA RESPONSABLE JEFE
(and) continued collecting pears.	cl.m(5d):coger+guardar-fruta cl.e(B):SACO
he felt sorry for the girl.	CORAZÓN.FORMA cl.d(5d&amp;gt;A):encogerse-corazón
They look at the jar surprised	cl.d(5d):frasco RANA cl.e(Hd):RANA-en-frasco cl.e(C):FRASCO
It stays upright.	cl.e:CASA
This son and the other sons (asked themselves): "How do we resolve this?	INDX.PRO:3sg INDX.PRO:3sg HIJO OTRO G:interrogativo CÓMO SOLUCIÓN CUÁL
Kuma took Arua home and looked after her.	G:Kuma cl.m(C):colocar-persona
They walked in a row following the footsteps	cl.c(I):PIE-pisar cl.e(1):PERSONAS-desplazarse
Find where it is	BUSCAR(2Msu) DÓNDE
"I feel happy	G:pensativo SENTIR CONTENTO
Listen [something]	ESCUCHAR(2) B:G(5):calma
He rises	cl.e(2b):PERSONA-levantarse-suelo cl.e(Bh):SUELO
and gallops with the boy bouncing about	cl.e(Hd):PERRO-saltar+hacia-árbol B:cl.e(5):ÁRBOL
The man (is) up in the tree	HOMBRE cl.e(2d):PERSONA-ascender-árbol cl.e(5):ÁRBOL
"Hello” (says the wolf mockingly).	SALUDO
(to) keep things in	COSA ARROJAR(2Msu)
"I will take advantage of the chimney" (thinks the wolf).	INDX B:cl.e:CASA APROVECHAR B:cl.e:CASA
(way up in the) tree (top)... (there are many) pears	ÁRBOL cl.e(5):ÁRBOL hhh PIEDRA- PERA4 PERA4(Q) cl.e(5d):PERAS-en-árbol cl.e(C):ÁRBOL-tronco
The child on the bike approached  pedalling at a good pace.	cl.e(Xa):BICICLETA-aproximarse cl.e(B):SACO BICICLETA HOMBRE B: BICICLETA BICICLETA BICICLETA
It was the pear that had fallen earlier.	LO-DE-ANTES cl.e(Cc):FRUTA-caer-suelo cl.e(Bh):SUELO INDX
(but) leaves it (in the basket)	cl.m(5d&amp;gt;5):echar-fruta
A flower blossomed in front of the dumbfounded Arua	FLOR cl.e(Cc&amp;gt;5d):FLOR-abrirse
The frog looked out	cl.e(2d):asomarse-frasco cl.e(B):FRASCO
The dog is behind him // both stare for a while.	B:cl.e(Hd):PERRO-huir-abejas cl.e(1):PERSONA-correr
The seven were transformed into butterflies and	cl.e(2):PERSONAS7-moverse cl.e(5):PERSONAS7-moverse MARIPOSA
of a similar age to the boy.	IGUAL2(1M) EDAD ALTURA-SEMEJANTE LOS-DOS B:ALTURA-SEMEJANTE
Each one has a different character.	CADA-UNO TIPO DIFERENTE
"Here three pears for helping me."	TRES PERA4(Xc) AYUDAR MOTIVO G
loaded with pears	cl.m(4d):agarrar-delantal AHORA B:cl.m(4d):agarrar-delantal cl.m(4d):agarrar-delantal
one noticed	UNO MIRAR
and they will surely go looking for her.	BUSCAR(2Msu) ES.SEGURO(1M) G
There is a solution and	HABER UNO
(continues) looking	MIRAR
Calm down I will help you."	TRANQUILO AYUDAR
There is the second house" thought the wolf.	MIRAR B.L(2) INDX:segundo INDX B:INDX:segundo cl.e:CASA
The boy dangles between the deer’s horns during the gallop	cl.e(Hd):PERRO-levantarse+hacia-árbol B:cl.e(5):ÁRBOL
(They arrived) to a forest with many trees and there was a wasp hive in one of them.	PAISAJE UNO ÁRBOL cl.d(5h):copas-árboles UNO ÁRBOL cl.e(Q):COLMENA-en-árbol cl.e(5):ÁRBOL HABER B:cl.e(5):ÁRBOL AVISPA
He was surprised	MENTE-APAGADA(1M) B:cl.m(4d):agarrar-delantal
He could face these animals	ANIMAL2 CONTRA CONTRA PODER
(He is) sitting	cl.e(2d):PERSONA-sentarse cl.e(Bh):SUELO
Explain the other solution to me."	EXPLICAR G:extrañeza OTRO G:extrañeza
and it is stuck	cl.e(C):FRASCO-en-cabeza
stretched a leg to the ground	cl.c(X):PATA-estirar cl.c(X):PATA
(They were) in bed both of them	CAMA LOS-DOS B:CAMA
and sees (something at the top).	B:MIRAR MIRAR
The bales of hay are thrown about	cl.e(1):PALOS-ascender
and holds the apron (to empty its contents into the basket and)	cl.m(A):coger-delantal
(The child continues) slamming [the ball] with the racquet	cl.m(Xc):accionar-raqueta
Two of them approached the boy	cl.e(1):PERSONAS2-aproximarse
looked down on (the place)	MIRAR
Calls out (to the frog)	GRITAR2
You know what?	SABER
(a tennis) racquet	cl.m(Xc):sostener-raqueta cl.d(Ca):forma-raqueta
[And finally] went (and)	CAMINAR(MP)
[In the story there is] a child whose sign is this [hair-child]	HOMBRE PEQUEÑO2 SIGNO SN:NIÑO
In the evening (Arua feared the approaching) night.	TARDE NOCHE
"Look the two (houses have been built) the same" (said the pig with the wooden house).	VER B:LISTO LOS-DOS B:LISTO IGUAL VER LISTO
"Wait" (said) the wolf to them.	LOBO ESPERAR2
(she continues) to be silent".	SILENCIO^SUELO
They got into bed and fell asleep.	MISMO HORA.RELOJ ACOSTARSE DORMIR(MP)
You know that there are animals there: tigers pumas...	SABER INDX ANIMAL2 G:prosódico TIGRE cl.c(5d):garras-andar G:pausa
(The first man) sees the second one	MIRAR
I'm going to give you a solution	INDX.PRO:1sg DAR(L)(2M) SOLUCIÓN
and sees the three boys	HOMBRE cl.e(3):PERSONAS3-aproximarse
[The apron] is tied at the back.	cl.m(Xc):atar-delantal
(The brother who was) building: "What?"	CONSTRUIR QUÉ
The wooden poles fly off.	MADERA cl.e(1):PALOS-ascender
He ties the scarf on his neck again.	cl.m(Xc):atar-pañoleta
and begins to search here	B:MIRAR cl.e(2b):PERSONA-desplazarse-con+perro cl.e(2b):PERRO-desplazarse-con+persona
and fell to the ground.	CAER
(but) makes noise	SONIDO(2M)
(That) would kill them	MORIR(MP)
"Where (could she be)?"	SN:ARÚA DÓNDE
She did not speak a word.	INDX.PRO:3sg NADA G:duda
"There	MIRAR
(There are) three baskets.	CESTO cl.m(Xc):posar-cesta cl.m(Xc):posar-cesta cl.m(Xc):posar-cesta
The girl with braids	MUJER cl.d(2p):trenzas
By moving the racquet	cl.m(Xc):accionar-raqueta
the wolf is here	INDX B:ESCUCHAR(2M) HABER B:ESCUCHAR(2M) PERRO B:ESCUCHAR(2M)
at that moment the dog was chased by a swarm of wasps	INDX MISMO HORA.RELOJ INDX B:HORA.RELOJ SN:PERRO B:HORA.RELOJ cl.d(Cc&amp;gt;5):perro-huir B:HORA.RELOJ AVISPA(1M) B:HORA.RELOJ cl.d(5):enjambre-desplazarse
"I'll try for the third time" (thinks) the wolf.	LOBO B.L(3) INDX:tercero
Then what is the matter?	ENTONCES PROBLEMA QUÉ
Looked under the bed and	CAMA cl.e(1):PERRO-desplazarse+bajo-cama cl.e(1I):CAMA
Leaper with its rodent teeth	INDX cl.e(2d):ANIMAL-ascender-madriguera cl.e(B):MADRIGUERA
"Brother	AVISAR
on the bicycle	cl.m(A):subir-cesto BICICLETA
"Do you know why?	MOTIVO INDX.PRO:2sg SABER
The boy sees an owl in the distance.	VENTANA cl.e(2d):PERSONA-asomarse-con+perro cl.e(2d):PERRO-asomarse-con+persona
The dog rejoices	INDX CONTENTO
His hat fell (to the ground)	cl.d(Q&amp;gt;5):sombrero-caerse-hacia-atrás cl.d(Lc&amp;gt;5):sombrero-caerse-hacia-atrás
Do you want me to?	QUERER
The next morning she was alone in the forest.	TRANSCURRIR DÍA G INDX SOLO2 MONTAÑA
(and) he fell	cl.e(Xa):BICICLETA-caer B:cl.e(5d):PIEDRA
says nothing.	SILENCIO
She did not feel any pain and	DOLOR HABER-NO
they helped him.	AYUDAR
Then the boy looks up high	ENTONCES SN:niño MIRAR
Leaves It	MIRAR(2M)
creating a surface wave in the water	cl.e(Hd):PERRO-alejarse-árbol B:cl.e(5):ÁRBOL
The two pigs (witness) that the house is breaking apart	DOS CERDO cl.e(1):PALOS-ascender
and is happy.	CONTENTO
The dog who had his snout in the jar jumped out of the window.	PERRO B:VENTANA INDX B:VENTANA cl.e(Hd):PERRO-entrar-frasco cl.e(B):FRASCO cl.e(C):FRASCO-descender cl.e(Q):CABEZA-salir-ventana cl.e(B):VENTANA
(The man) sees a goat with a bell	MIRAR INDX cl.e(Qa):CAMPANA cl.d(L):cuernos-forma
It remains there with its snout in the jar.	cl.e(C):FRASCO-en-cabeza
and leaves/goes.	INDX CAMINAR
The seven gazed into the distance	cl.e(2):PERSONAS7-girarse cl.e(5):PERSONAS7-girarse
"How (can that be? thinks the unbelieving wolf).	G:incredulidad CÓMO
until the lungs are full of air	cl.d(5):pecho-hinchar
He saw that the baskets were getting full	MIRAR B:ASÍ LISTO
"Thank You he said"	GRACIAS(1M) B:cl.m(5d):agarrar-fruta
How/what happened?	CÓMO TRANSCURRIR
(because) Arua (has not said) anything about marriage	INDX SN:ARÚA CASAR NADA
Upon seeing this	cl.e(2):PERSONAS7 cl.e(5):PERSONAS7
returned the frog	DAR(2M)
a man passes by	HOMBRE VENIR
(and jokingly says): Hello!	SALUDO
Please advise!" (said Kuma.)	ACONSEJAR G
It slams the hive with one leg	cl.c(5d):patas-moverse cl.m(5d):tocar-colmena cl.m(5d):pata cl.e(5d):colmena cl.m(5d):tocar-colmena B:cl.e(5d):COLMENA cl.c(5d):patas-moverse
"Ah!" "I (can) clean it with the handkerchief” (he thought)	G:¡ah! cl.m(5d):agarrar-pera PAÑOLETA cl.m(4d):frotar-fruta cl.m(C):agarrar-fruta PURO B:cl.m(C):agarrar-fruta
Looking for it	cl.e(2d):PERRO-desplazarse
(The wolf) is coming!"	AHORA VENIR
and thanked the youngsters	HOMBRE B:cl.e(Bl):BICICLETA GRACIAS
Since the child had fallen	MOTIVO B:AYUDAR cl.e(Xa):BICICLETA-caer-suelo cl.e(Bh):SUELO
One of the three boys who were walking	cl.e(3):PERSONAS3 INDX cl.e(3):PERSONAS3-desplazarse
puts the basket on top of the bicycle	cl.m(Xc):colocar-cesta
The sock (is) halfway (up to) the shin bone.	CALCETÍN2 cl.d(Bl):calcetín-subido cl.c(Bl):pierna
down below is the frog surprised to see them	MIRAR
and the dog (sleeps) at the foot of the bed	PERRO B:ACOSTARSE cl.e(2d):PERRO-sobre-cama cl.e(Bh):CAMA
And works quite a bit.	ARREGLAR SECCIÓN- B:ARREGLAR BASTANTE B:ARREGLAR ARREGLAR
he returned again	INDX B:cl.m(5d):agarrar-rana OTRA-VEZ VOLVER
leans against the tree	ÁRBOL cl.e(2b):PERSONA-apoyarse-árbol cl.e(5):ÁRBOL
(The man is annoyed but continues) plucking the pears.	G cl.m(5d):coger+guardar-fruta cl.e(5d):delantal
focused on work.	MENTE^CONCENTRAR TRABAJAR G(B):vale B:TRABAJAR
everything was back in place in the basket.	LISTO G:todo-preparado CESTO
Years passed and	TRANSCURRIR
"The knee hurts" (he says).	DOLOR INDX G:tocarse-rodilla
Hmm...	B:cl.e(2d):PERSONA-sentada PERRO cl.e(2d):PERSONA-sentada-con+perro cl.e(Hd):PERRO-sentado-con+persona
and they began to walk	CAMINAR(MP)
and flee.	cl.e(2):PERSONAS2-alejarse-suelo cl.e(Bh):SUELO
She looked in all directions;	MIRAR
They also called out to it (where could it be?)	MISMO B:G:interrogativo LLAMAR B:G:interrogativo G:interrogativo
The weather was hot like in the summer.	CLIMA BUENO IGUAL VERANO B:IGUAL ES.ASÍ
The seven sons of Kuma [began] looking for her and	HIJO SIETE SN:KUMA BUSCAR(2Msu)
You (built) yours too fast - the two brothers-	MOTIVO INDX LOS-DOS HERMANO RÁPIDO
and the jar breaks	DESAPARECER
The man continued picking pears and upon finishing	cl.m(A&amp;gt;5):coger+guardar-fruta B:cl.e(B):SACO LISTO(1M) B:cl.e(B):SACO
The dog walks at their side	cl.e(2b):PERSONA-caer+de-ciervo cl.e(Hd):CIERVO-arrodillado CAMINO AGUA B:CAMINO cl.e(2b):PERSONA-caer-charco cl.e(Xa):CHARCO
(was) picking [pears]	COGER(2Msu)
Come."	VENIR2
And the child	MIRAR SN:niño
Lights a fire.	cl.m(Xc):colocar-olla SABER COCINAR
and bring (your) house down".	cl.e:CASA-desintegrarse
A person... No sorry.	UNO PERSONA PERDÓN
(and saw that) they had pears.	HABER cl.m(B):llevar-peras PERA
because the wolf has blown" (them said the pig nervously).	PORQUE LOBO SOPLAR(2M)
(to the point where) the footprints disappeared.	cl.c(I):PIE-pisar DESAPARECER
The child continues the search	HOMBRE SN:niño BUSCAR(2Msu)
(and) gave them to the children.	DAR
The (brother): Relax	INDX TRANQUILO
She felt comforted	SENTIR CONTENTO
The pig watches in desperation	CERDO cl.m(5):vibrar-ventana
coming out of the hive	cl.e(C):FRASCO
and he peered over the top.	cl.e(2d):PERSONA-ascender+a-tronco cl.e(Bh):TRONCO
climbed back into the tree	AHORA OTRA-VEZ cl.e(2d):PERSONA-ascender+a-árbol cl.e(5):ÁRBOL
(There appears) a little blond boy wearing a hat and a scarf	HOMBRE PEQUEÑO2 RUBIO cl.d(Xa):sombrero PAÑOLETA
The wolf moves back.	LOBO cl.c(1):PATAS-retroceder
(a bit) strange.	RARO G
when the bike collided with a stone	PIEDRA cl.e(Xa):BICICLETA-chocar-piedra cl.e(5d):PIEDRA
(is) collecting pears.	G:hombre cl.m(5d):coger+guardar-fruta cl.m(5):agarrar-saco
(Arua gazed up at the moon amazed) "You are talking to me."	G:mirar-asombrado EXPLICAR
(The child) is astonished with this	MENTE-APAGADA INDX
One of the children the eldest approached Kuma	INDX HOMBRE hhh PRIMERO PRINCIPAL G:acercar-Kuma
"I will take care of you and my seven children	QUERER CUIDAR MÁS.SUMA INDX PROPIO(2M) SIETE NACER
and disappeared.	DESAPARECER(1M)
which looks at him in the eyes	MIRAR(MP) BOSQUE
A man with a hat	HOMBRE PERSONA SOMBRERO(Xc) B:SOMBRERO(Xc)
gets off the bike	BICICLETA cl.e(2d):PERSONA-descender+de-bicicleta cl.e(Bh):BICICLETA
A frog whose sign is this	RANA SIGNO SN:rana
chased by a swarm of bees	ROPA cl.m(5&amp;gt;Q):coger-prenda cl.m(Xc):examinar-prenda cl.m(Xc):agarrar-prenda
take a basket	cl.m(Xc):coger-cesta
It was with its partner	cl.e(1):RANA-con-rana PAREJA
It begins to descend	FÁCIL B:cl.e(C):CHIMENEA cl.e(2b):LOBO-descender+por-chimenea B:cl.e(C):CHIMENEA
Among the people living there	VIVIR PERSONA B
while on the go	cl.e(2d):PERRO-desplazarse+con-persona cl.e(1):PERSONA-desplazarse+con-perro
(Then) he sees branches arranged like a fan (opposite him)	MIRAR cl.d(Lc):rama-forma cl.e(4):RAMAS-fila
"I want to marry Arua"	QUERER LOS-DOS CASAR
picking (pears)	COGER(2Msu)
(The wolf) gets ready	AHORA MÁS-O-MENOS PREPARAR(1M)
(But) the frog has disappeared	PERRO- RANA DESAPARECER
and approaches leaping	MIRAR B:cl.e(C):frasco
meaning "star of the night"	SIGNIFICAR TÍTULO ESTRELLA NOCHE
(and) help him.	AYUDAR
"Complicated" (thought) the child which had fallen	cl.e(2d):PERSONA-caer-suelo cl.e(Bh):SUELO COMPLICADO
he looked at them attentively	MIRAR B:cl.e(B):TRONCO
climbed up	cl.e(2b):PERSONA-ascender+por-tronco cl.e(B):TRONCO
The boy has gone to bed	HOMBRE PEQUEÑO2 ACOSTARSE
The next day at sunrise	MAÑANA DÍA
The boy looks surprised at the frog which in turn looks at him.	CIERVO
(The wolf) takes a (deep) breath	RESPIRAR- DOBLE cl.d(5&amp;gt;5d):aire-respirar
Pedalling (into the distance).	BICICLETA G:alejarse
"Yes yes" (answers the wolf convincingly.)	(CNM)
and said to him: "I want to marry Arua"	QUERER LOS-DOS CASAR
The dog [dog-ear] looked searched and rummaged everywhere	PERRO B:MENTE-APAGADA SN:PERRO B:MENTE-APAGADA MIRAR B:MENTE-APAGADA BUSCAR(2Msu) BUSCAR(2Msu) cl.e(1):PERRO-desplazarse BUSCAR(2Msu)
and to gallop with the boy on its head	PERRO B:cl.e(5):ÁRBOL cl.e(Hd):PERRO-aproximarse-árbol B:cl.e(5):ÁRBOL
He took the hat to the boy	cl.m(Q):agarrar-sombrero
"They gave the hat"	cl.m(Q):dar-sombrero SOMBRERO(Xc) G:narrador
sees a hole in a tree trunk	MIRAR cl.d(1):círculo-forma cl.e(B):CÍRCULO ÁRBOL cl.e(5):ÁRBOL cl.d(Oa):tronco
The dog also falls into the water	cl.e(Hd):PERRO-huir-abejas cl.e(Lc):ABEJAS-seguir-perro
one (is) waving (a tennis) [racquet]	cl.e(1):PERSONA cl.m(Xc):accionar-raqueta
and screams	GRITAR2 B:cl.m(A):agarrar-rama
The house is solid.	CASA PIEDRA
"I have found another solution	YA SOLUCIÓN HABER
The dog begins to walk towards the trunk	PIEDRA cl.e(5d):PIEDRA
supporting its feet on the trunk.	cl.m(Bd):apoyarse-en+tronco
Listen!	ESCUCHAR2 INDX
"Ah!"	G:¡ah! B:cl.m(Q):elevar-sombrero
(and looks at the baskets with) pears in front of him.	PERA4 INDX
and warns:	AVISAR
puts it in his apron pocket	cl.m(5d):guardar-fruta B:cl.e(C):SACO
"it hurts!" (he says)	DOLOR
They see something that makes them stop	MIRAR(2M)
End.	FIN
and blows.	SOPLAR(2M)
The frogs are on top of the trunk in a row from largest to the smallest	CIERVO cl.e(2b):PERSONA-sobre-cabeza+ciervo B:CIERVO
A child whose sign is this	INDX HOMBRE PERSONA SN:niño
The pig calls:	CERDO LLAMAR
The three pigs approach the window.	VENTANA cl.e(3):PERSONAS3-aproximarse B:VENTANA
(and) leaves	ALEJARSE
(Kuma) walked away	ALEJARSE
that is billowing smoke.	cl.d(5d):humo B:cl.e:CASA cl.e(5d):CHIMENEA B:cl.e:CASA
(but) the house (just) vibrates	cl.e:CASA-moverse
"Let's go."	cl.e(55):AVE-volar
(He makes sure that no one is looking).	B:cl.m(5d&amp;gt;5):echar-fruta
Picks the frog gently	cl.m(Qa):coger-rana cl.m(Bd):coger-rana
(continues) looking	MIRAR
I am going to narrate it.	AHORA EXPLICAR
The child (looks at the girl) open mouthed	HOMBRE BICICLETA
The boy had forgotten the hat	SOMBRERO(1M) B:cl.m(Q):coger-sombrero OLVIDAR B:cl.m(Q):coger-sombrero
(There is) a ladder up the tree.	cl.e(2d):ESCALERA-sobre-suelo cl.e(Bh):SUELO cl.e(5):ÁRBOL-sobre-suelo cl.e(Bh):SUELO
"Wait!"	ESPERAR2(2M)
the ball bounces.	cl.m(Xc):sostener-raqueta cl.e(O):PELOTA-botar
He then saw three young boys	CASUAL B:cl.c(1):PIERNA MIRAR B:cl.c(1):PIERNA TRES B:cl.c(1):PIERNA JOVEN B:cl.c(1):PIERNA TRES B:cl.c(1):PIERNA
"(is coming) from that fallen tree"	ÁRBOL cl.e(5):ÁRBOL-caer ESCUCHAR(2) INDX
and frightens (the boy).	ASUSTAR
The first loves to play	INDX:primero B.L(1) ENCANTAR JUGAR(CT)
into the distance.	cl.e(1):TRAIECTORIA-desplazarse
The (girl’s) bike was approaching.	cl.e(Xa):BICICLETA-desplazarse B:ALTURA-SEMEJANTE
approaches the boy	cl.e(55):AVE-volar
"Wait wait."	ESPERAR2(2M)
Another (person) a boy	OTRO xxx HOMBRE PEQUEÑO2
another enters the wooden house	OTRO CASA MADERA DENTRO
The boy opened the window	VENTANA cl.e(L):VENTANA-ascender cl.m(A):subir-ventana
"Not there"	NO
The wolf is at the mouth of the chimney	cl.e(2d):PERSONA-entrar-chimenea cl.e(C):CHIMENEA
The seven brothers stood before Kuma	EXPLICAR- ALGUNO.PERSONA SIETE cl.e(2):PERSONAS7-aproximarse cl.e(5):PERSONAS7-aproximarse
and the boy was still trying to manage his bike	cl.m(A):agarrar-manillar
(and wants) to peep inside	MIRAR
the ball bounces back and forth;	cl.m(Xc):sostener-raqueta cl.e(O):PELOTA-botar
and is happy.	CONTENTO
Well almost finished" (says the third pig).	CASI cl.e:CASA LISTO
"No (I don’t think so" says) the pig.	CERDO (CNM)
They look at each other	MIRAR(2M)
The scene of this story is a grove with pears	SITUACIÓN INDX BOSQUE(M-AD) MÁS.SUMA PERA4(Xc)
(but) [Arua] (stayed) silent	SILENCIO
Hmm...	cl.e(5d):FRASCO-descender
illuminated by the light of the moon.	LUZ cl.e(Cc&amp;gt;5d):FLOR-abrirse
distributed the pears between them.	REPARTIR
left her on mount.	ARROJAR MONTAÑA
and it has (only) been shaken" (thought the wolf).	cl.e:CASA-moverse
Arua: "Wait"	SN:ARÚA G:pensárselo ESPERAR2(2M)
and said goodbye.	DECIR B:DAR(2M) SALUDO B:DAR(2M)
It approaches (the house)	cl.c(1):PATAS-andar
The boy fell backwards.	cl.e(2d):PERSONA-caer+de-tronco cl.e(Bh):TRONCO cl.e(2b):PERSONA-caer-suelo cl.e(Bh):SUELO
He sees a large stone	PIEDRA cl.d(C):piedra-forma B:cl.d(C):piedra-forma MIRAR
The boy climbed on the bike	cl.e(2b):PERSONA-ascender+a-bicicleta cl.e(Bl):BICICLETA
The deer puzzled with the stowaway starts to move its head	MIRAR B:cl.e(5):ÁRBOL
and their children	HIJO HOMBRE PEQUEÑO2(2M) G(5)(2M):evidencia
stunned the pig flees	G(5):desesperación cl.e(2b):PERSONA-sobre-suelo cl.e(Bh):SUELO cl.e(A&amp;gt;5):POLVAREDA-alejarse-suelo B:cl.e(Bh):SUELO
(and) helped him.	AYUDAR INDX
to finish the house quickly.	PORQUE RÁPIDO INSTANTE CASA(M-AB) YA B:CASA(M-AB)
The dog and the boy are walking.	cl.e(2d):PERRO-desplazarse+con-persona cl.e(1):PERSONA-desplazarse+con-perro
It is working (fast)	ARREGLAR
(The boy) continues cycling	cl.e(Xa):BICICLETA-desplazarse
to search here	CAMA ACOSTARSE
When in the water (he said) "What a fright!"	AGUA B:cl.d(5h):onda-acuática cl.d(5):agua-superficie ASUSTAR B:cl.d(5):agua-superficie G:alivio B:cl.d(5):agua-superficie
The deer starts running	cl.d(5):cuernos-tamaño cl.c(A):patas-correr
He assigned Arua	DL:ARUA DAR(2M)
The owl flies over him	cl.e(C):FRASCO-en-cabeza
Another pig the second one is also working (on a house) a wooden house.	OTRO CERDO B.L(2) INDX:segundo TAMBIÉN ARREGLAR CÓMO MADERA
The mass of air impinges on the house.	cl.d(5):aire-contra-casa
The child (was in) his room	HABITACIÓN SU SN:NIÑO
wasps swarm out	cl.e(Lc):avispas-desplazarse cl.d(Lc):avispas-desplazarse
They continued walking.	cl.e(3):PERSONAS3-desplazarse CONTINUAR
She felt a pain in her heart.	SENTIR CORAZÓN.FORMA DOLOR B APUÑALAR G
walks (towards the boy with the racquet).	cl.e(2b):PERSONA-aproximarse
up in the tree.	INDX PERA4(Xc)- ÁRBOL
It is solid.	DURO B:cl.e:CASA
The boy moves away from the [owl’s] nest	INDX SN:niño cl.e(2d):PERSONA-alejarse-suelo cl.e(Bh):SUELO
(and continues) picking pears from the tree	ÁRBOL cl.m(5d&amp;gt;5):coger+guardar-fruta cl.m(5):agarrar-saco
(Kuma was) thoughtful.	G PENSAR(2Msu)
They are searching.	MIRAR
he uprights the bike	cl.e(Xa):BICICLETA-levantarse-cesta+referencia cl.e(Xa):CESTA
that is open	cl.e(B):VENTANA-ascender cl.e(Bh):VENTANA
The dog runs toward the tree	BUSCAR(2Msu)
End.	HOMBRE DOS VERDAD
She looked around	MIRAR
As she walked	CAMINAR(MP)
and the two (pigs) the same ones as before which were playing hear (the noise).	DOS MISMO LO-DE-ANTES DOS JUGAR(CT) ESCUCHAR(2M)
calling out to the frog.	GRITAR2 B:CAMINAR(MP)
the children help him to	INDX HOMBRE AYUDAR
thinking all along.	PENSAR(2Msu)
(and wonders whether to)	B:MIRAR
(and one can see) the sun set	ANOCHECER
and he had left fleeing	VOLAR
moves into the distance.	cl.e(2d):ANIMAL-alejarse-madriguera cl.e(B):MADRIGUERA G(5):allá-va
Let’s make a deal let her decide	INDX BIEN DIRECTOR ESCOGER
Arua was obedient good-hearted and very pretty.	INDX MUJER SN:ARÚA YA G OBEDECER BUENO.CORAZÓN BONITO^MARAVILLA G
In front of them is a wood	cl.d(5d):frasco cl.m(C):examinar-frasco
"to hell I prefer a basket."	A-POR-TODAS B:cl.m(5d):coger-fruta UNO B:cl.m(5d):coger-fruta CESTO QUERER B:CESTO INDX B:CESTO
"Are you sure?" (asked) the brother.	INDX HERMANO ES.SEGURO(1M)
(The wolf) comes nearer (quietly)	cl.c(1):PATAS-andar
and fell into the water.	AGUA B:cl.e(2d):PERRO-caer-con+persona cl.e(2d):PERSONA-caer-con+perro cl.e(2d):PERRO-caer-con+persona cl.d(A&amp;gt;5):onda-acuática cl.d(5h):onda-acuática
breathes (deeply)	RESPIRAR
into the distance.	cl.e(2b):PERSONA-ascender+a-bicicleta cl.e(1):BICICLETA G
attached to the racquet by a rope	B:cl.m(Xc):sostener-raqueta CUERDA
He looks up	MIRAR
Night approached	YA NOCHE
They escape each running away on its own	DOS B:ALEJARSE(2Msu) ALEJARSE(2M)
and moves towards the hive	BUSCAR(2Msu)
into the water	AGUA cl.d(5):agua-ascender
Looks on one side...	MIRAR
I will defend you from the animals from the tiger.	INDX ANIMAL2 TIGRE G:animal-atacar INDX.PRO:2sg DEFENDER
Calm down this  house is impossible (to break)	TRANQUILO INDX IMPOSIBLE(M-RE)
It is night	NOCHE
One frog climbs into his hand	cl.e(2b):PERSONA-sobre-ciervo cl.e(Hd):CIERVO-correr
stretched its legs to get out	cl.c(X):PATAS-andar
The three children were walking two continued (and)	B:cl.e(3):PERSONAS3 B:cl.e(3):PERSONAS3 INDX CAMINAR cl.e(2):PERSONAS2-alejarse INDX
the wooden house	OBJETIVO IR MADERA CASA
The flower containing Arua closed	cl.e(5d&amp;gt;Cc):FLOR-cerrarse-persona cl.e(1):PERSONA
and he was annoyed	INDX B G(1):fastidio B
And then... [The first man] is still up	ENTONCES(1M) ENTONCES xxx INDX CONTINUAR
(and) disappeared	ALEJARSE
and from inside came out a smelly rodent.	RATÓN B:cl.e(C):MADRIGUERA G:repugnancia B:cl.e(C):MADRIGUERA OLER^MAL-OLOR B:cl.e(C):MADRIGUERA INDX B:cl.e(C):MADRIGUERA RATÓN B:cl.e(C):MADRIGUERA
The man kept (at his task which is what) saved the child (who) disappeared into the distance	HOMBRE PERSONA CONTINUAR SALVAR ALEJARSE
He continued pedalling with difficulty and continued on his way.	BICICLETA cl.e(Xa):BICICLETA-alejarse-suelo cl.e(Bh):SUELO
and blows (the air) out	cl.d(5):pecho-deshinchar
spellbound	cl.e(Xa):BICICLETA-desplazarse
I give you other solution."	DAR(L)(2M) OTRO SOLUCIÓN
It was a dangerous flower.	VER^DEBER FLOR
You are cold blooded. [?]	HIELO G:¡venga!
(and after) filling its chest (with air)	cl.d(5d):pecho-hinchar
Later another brother also said he’d want to marry her:	OTRO HERMANO DESPUÉS PEDIR(1M) TAMBIÉN
The dog barked	PERRO B:cl.m(A):agarrar-cuernos LADRAR(MP)
pears.	cl.e(5d):peras-caer+individual
the bed is behind them	CAMA cl.e:CAMA-localización
and the third in the one built with bricks enters (also at home).	OTRO CONSTRUIR LISTO AHORA DENTRO
and get completely wet.	cl.d(A&amp;gt;5):agua-descender
and next to it their progeny in a row	cl.e(2b):PERSONA-caer-ciervo
(falling from the top)	MIRAR
(and had seen) him falling from the bike.	cl.e(Xa):BICICLETA-caer+de-suelo cl.e(Bh):SUELO
cycling the heavy bike with difficulty	BICICLETA FUERTE cl.m(A):agarrar-manillar
(and from there) looks	MIRAR B:cl.m(A):agarrar-rama
The petals opened more and more	cl.e(C&amp;gt;5d):FLOR-abrirse cl.d(L&amp;gt;Lc):pétalos-forma cl.e(C&amp;gt;5d):FLOR-abrirse cl.e(5d):FLOR-ascender
at the flower containing Arua.	cl.e(5d&amp;gt;Cc):FLOR-cerrarse-persona cl.e(1):PERSONA
and left.	ALEJARSE B:cl.m(5d):agarrar-fruta
"(My) children want to ((?))" he said to himself concerned.	HIJO QUERER INDX.PRO:3pl G:pensar-con-preocupación
When the three boys approached	cl.e(3):PERSONAS3-aproximarse B:cl.e(B):TRONCO
(The boy) falls.	cl.e(2d):PERSONA-caer+de-suelo cl.e(Bh):SUELO cl.e(2d):PERSONA-caer-ciervo cl.e(Bh):CIERVO
"Quiet" he shouts to the dog	cl.e(Hd):PERRO-huir-abejas cl.e(Lc):INSECTOS-seguir-perro
The boy (who was) looking for (the frog) and calling (the frog) felt a (big) rumble.	BUSCAR B:cl.e(B):VENTANA GRITAR2 B:cl.e(B):VENTANA SONIDO B:cl.e(B):VENTANA
The two (pigs) enter (the third house).	LOS-DOS DENTRO
It is hard cycling a bike around bends.	cl.m(A):agarrar-manillar G:dubitación COSTAR cl.m(A):agarrar-manillar
It is a strong house" (thought the wolf).	CASA(M-AB) DURO2
It walks (tracking the area).	cl.c(1):PATAS-andar
and so did Arua.	SN:ARÚA cl.e(1):PERSONA-aproximarse
(and after) filling its lungs (with air)	cl.d:pecho-hinchar
You brought her up	CUIDAR
He looked up the tree	MIRAR B:BICICLETA ÁRBOL MIRAR B:ÁRBOL
The owl flies away	MIRAR(MP)
but could hardly manage to ride the bike	cl.m(A):agarrar-manillar COSTAR B:cl.m(A):agarrar-manillar cl.m(A):agarrar-manillar
Look through the window	CARA B:TRANQUILO TRANQUILO MIRAR G:esperar
The girl was cycling gracefully.	MUJER BICICLETA
A tiger was approaching	ANIMAL2 TIGRE cl.c(5d):garras-andar
What a melancholy! How painful!".	DEPRESIÓN DOLOR G:prosódico
picking the pears.	cl.m(5d&amp;gt;5):coger+guardar-fruta cl.e(B):SACO
he listened.	ESCUCHAR B
The boy	cl.m(5):apoyarse-en+tronco
and the boy runs away	VENTANA B:VENTANA cl.e(2d):PERRO-asomado PERRO B:cl.e(2d):PERRO-asomado cl.e(C):FRASCO-en-cabeza
The house is shaken.	cl.e:CASA-moverse
and leaves the fruit in a basket.	cl.d(5d):cesta cl.d(5):cesta ARROJAR B:cl.d(5):cesta
He rises	cl.e(2b):PERSONA-levantarse-suelo cl.e(B):SUELO
Not as bad as the death of your children	INDX.PRO MORIR(2Msu) IGUAL2 HIJO NO
The boy looks out the window	cl.e(2d):RANA-ascender+a-frasco B:cl.e(C):FRASCO
How (does) he (work)?	PERSONA CÓMO cl.c(X):PIERNA
and runs to	cl.c(1):PATAS-correr
Where could it be?	BUSCAR(2Msu) G:interrogativo G:interrogativo
to smell it	OLER2 B:cl.e(B):FRASCO
and returns home happily.	VOLVER CASA FELIZ
The boy picked his frog in his hand	INDX B:cl.m(5):apoyarse-en+tronco cl.m(5d):coger-rana INDX B:cl.m(5d):coger-rana cl.m(5d):coger-rana
I will huff 'n puff with ease	FÁCIL LOBO SOPLAR
All present there said: "Okay	INDX.PRO:1pl G:pensar ACUERDO
containing pears (that the man had emptied) from the sack	cl.d(5d):saco-del-regazo AHORA HABER PERA cl.d(5d):cestas-llenas-de-peras
pursued by the swarm	PERRO B:MIRAR(MP) cl.e(C):FRASCO-en-cabeza
on the way he comes across a rock.	cl.d(A&amp;gt;5):frasco-estallar
Surprising.	G:sorpresa MENTE-APAGADA(1M)
He sees a hat on the floor.	MIRAR SOMBRERO(Xc) cl.e(Xa):sombrero-tirado
at full speed	cl.m(A):agarrar-cuernos
I have worked for very long on this house	INDX.PRO:1sg TRABAJAR HORA CONSTRUIR
the fat one wearing a hat and scarf	GORDO SOMBRERO PAÑOLETA
One can hardly (pull down) a wooden house	MADERA DIFÍCIL
The sun has risen	YA AMANECER SOL
with a wide smile	cl.e(2b):PERSONA-sobre-ciervo cl.e(Hd):CIERVO-correr
The dog which was playing with the hive	PERRO VER cl.m(5d):tocar-colmena
(and) leaves.	ALEJARSE
puts the basket on the handlebar.	cl.m(A):colocar-cesta
He felt a roar	SONIDO(2M)
Until he	HASTA COGER(2Msu)
The second also (likes) playing	INDX:segundo B.L(2) TAMBIÉN B.L(2) JUGAR
He climbs down the tree	cl.e(2d):PERSONA-descender+de-localización cl.e(Bh):LOCALIZACIÓN
The (boy with the racket) gives him the hat	INDX cl.m(Q):dar-sombrero
breathes twice	RESPIRAR DOBLE
The man (is) working up (in the tree)	HOMBRE TRABAJAR INDX
and goes down the chimney	LOBO MENTE^NORMAL
The three children passed by.	cl.e(3):PERSONAS3-desplazarse
There is a glass window in front	VENTANA MIRAR cl.d(4):ventana-forma
The bike was ready to move	BICICLETA LISTO
He grabs the branches	cl.m(5&amp;gt;A):agarrar-rama
"to that tree trunk"	G.ADA
It is prepared	PREPARAR
(The boy) distributed the pears.	cl.m(Cc):dar-peras G
While the boy cycled into the distance.	cl.e(3):PERSONAS3-alejarse-bicicleta cl.e(Xa):BICICLETA-alejarse-personas3
(Arua) looked at the moon.	G:Arúa MIRAR
Right?	(CNM)
The glass jar was empty:	cl.d(C):frasco CRISTAL DESAPARECER
"Look at him!" (they thought)	MIRA-TÚ
It was a deer	CIERVO cl.d(5):cuernos-tamaño
(thinking): "I will now go down easily through here".	cl.e(2d):PERSONA-ascender+a-tejado cl.e(B):TEJADO
The two (terrified) pigs look out the window.	VENTANA LOS-DOS CERDO cl.m(5):apoyarse-ventana
(The child goes to) see (the frog)	MIRAR
The two begin to explore the place	cl.e(2d):PERRO-descender+de-cama B:cl.e(Bh):CAMA PERRO B:cl.e(Bh):CAMA cl.e(2d):PERRO-descender+de-cama B:cl.e(Bh):CAMA cl.e(2d):PERRO-con+persona cl.e(2d):PERSONA-con+perro
and flees the place	cl.e(1):PERRO-alejarse-localización cl.e(Bh):LOCALIZACIÓN
(Well) he climbs up the ladder	cl.c(X):PIERNAs-ascender+por
by chance the wolf hears them.	CASUAL LOBO ESCUCHAR
three baskets there.	INDX TRES CESTO
The man was confused.	HOMBRE COMPLICADO
The butterflies rose in the air flying	cl.e(55):MARIPOSA-ascender
The girl cycled into the distance.	MUJER ALEJARSE
It was a spade type racket with a ball tied to it that bounced back and forth.	cl.d(1):raqueta cl.m(Xc):raqueta VER cl.e(Cc):PELOTA-botar cl.m(Xc):accionar-raqueta
when the deer stops suddenly	cl.c(B):patas-frenar
(They) help(ed him).	AYUDAR
to a perch on a tree branch	B:MIRAR(MP)
and disappeared into the distance.	DESAPARECER
Then he took the basket picked it up and placed it (on the handlebar)	G:se-dispone-a-agarrar-cesta AHORA MISMO INDX cl.m(5d):colocar-cesta cl.m(Xc):colocar-cesta
It is not there	NO
and exits fleeing	cl.m(Q):levantar-objeto
(and the boy) thanked them	GRACIAS INDX(B)
with wasps swirling around	cl.e(Lc):AVISPAS-volar VOLAR cl.e(Lc):AVISPAS-volar
What is it?	CUÁL
and blows.	SOPLAR
he climbed on the bike	cl.e(2b):PERSONA-ascender+a-bicicleta B:cl.e(Bl):BICICLETA
and found a girl	MIRAR INDX.PRO:3sg MUJER PEQUEÑO2
Let me explain	INDX.PRO:1sg EXPLICAR
down	cl.e:CASA-desintegrarse
The boy climbs on the bike	BICICLETA cl.e(2b):PERSONA-ascender+a-bicicleta cl.e(1):BICICLETA
The child is looking for it	SN:niño BUSCAR(2Msu) DÓNDE
They began putting the pears back into the (basket) [that had fallen to the ground]	LO-DE-ANTES cl.m(A&amp;gt;5d):arrojar-peras cl.e(5):CESTO
(Under the tree) there was a line of three baskets	CESTO TRES B:CESTO CESTO TRES B:CESTO
It is sniffing the jar	cl.e(2d):PERRO+FRASCO-desplazarse cl.e(B):PERRO+FRASCO-desplazarse
She had felt the presence [of something]	SENTIR HABER
and wrapped around her completely.	cl.d(5):flor-cubrir-Arúa
(Pig) enters.	DENTRO YA
(The wizard looked at him) "You...".	G:pausa INDX.PRO:2sg G:pensar
He went home.	IR CASA(M-AB) G:prosódico
and it licked his face	cl.c(B):LENGUA-lamer B:cl.m(Bd):coger-perro
to (make the house) safe.	MOTIVO ES.SEGURO
The dog runs in terror	PERRO cl.c(B):patas-correr SN:perro cl.c(B):patas-correr
On the roof is a chimney	CASA cl.d(B):chimenea-sobre-casa cl.e:CASA HABER B:cl.e:CASA
How beautiful!	BONITO B:CASA
He looked down	MIRAR B:ÁRBOL
sees a burrow (on the ground)	MIRAR cl.d(1):madriguera-forma cl.e(C):MADRIGUERA
(until) its lungs are full (of air)	cl.d(5):pecho-hinchar
and shadows covered her.	SOMBRA
That is why (your homes are) weak.	MOTIVO DÉBIL
[Applause]	INDX G:asomarse MIRAR
(The wolf has) an idea	MENTE
(Kuma) reflected on the words.	G:extrañeza PENSAR(2Msu)
He had a beard and was wearing a wide-brimmed hat	cl.d(Qa):sombrero-ala-ancha cl.d(5d):barba-forma
and (the boy) left.	ALEJARSE
Looks from one side to another	cl.m(Bd):sostener-perro ACARICIAR
All were arguing	DISCUTIR
thinking of the frog	MENTE^OBJETIVO RANA
I have blown	SOPLAR
They will eat her	COMER2
blows.	SOPLAR(2M)
The house is shaken.	cl.e:CASA-moverse
and the third is serious	INDX:tercero B.L(3) UNO B.L(3) TRISTE B.L(3)
It breathes in once more	OTRA-VEZ RESPIRAR
The child searched for the frog from there.	cl.e(2d):PERSONA-asomarse B:cl.m(Bd):apoyarse-en+tronco
Both bikes crossed.	cl.e(Xa):BICICLETA-aproximarse-bicicleta
"Beautiful."	G:niño-observa cl.m(5):apoyarse-en+tronco BONITO B:cl.m(5):apoyarse-en+tronco
It sees them	INDX.PRO:1sg B:cl.c(1):PATAS-andar MIRAR B:cl.c(1):PATAS-andar
wondering what they could do.	G:ayudaremos
The seven kids left.	ALEJARSE(2Msu)
There is no movement inside the house	MISMO B:cl.e:CASA INDX B:cl.e:CASA cl.e:CASA-moverse NINGUNO
called Kuma	NOMBRE DL:KUMA
and looks at the knee.	MIRAR XXX
The (blond boy sees the hat)	BICICLETA B:BICICLETA
"Almost.. Its tough tough	CASA- COSTAR COSTAR
She thought about it a little	G:pensar PENSAR(2Msu)
(checks that the man is not looking at him)	B:cl.m(A):colocar-cesta
The pears he was carrying in the basket on the handlebar rolled and scattered on the floor.	PERA B:cl.e(5d):PIEDRA cl.d(A):manillar-de-bici CESTO cl.d(A&amp;gt;5):peras-expandirse
(The man) looks at them (but)	MIRAR
looking for it	BUSCAR
Arua has not said anything."	NADA INDX.PRO:3sg SN:ARÚA G:interrogativo
until	cl.e(Hd):RANA-alejarse-frasco B:cl.e(C):FRASCO
He though they had stolen the pears.	PENSAR INDX ROBAR INDX
The third (brother): "Are you guys OK?"	cl.e(2d):PERSONA-ascender+por-chimenea B:cl.e(C):CHIMENEA
and gets blown into smithereens	DÍA
They put the basket in place	cl.m(A):subir-cesto OTRA-VEZ(1M) LO-DE-ANTES
thinking about	MENTE^OBJETIVO
"It would be better leave Arua in the middle of the forest"	INDX.PRO:1sg BIEN(2M) SN:ARÚA ARROJAR MONTAÑA ARROJAR
puts it in ...	cl.m(5d):agarrar-fruta B:cl.e(C):SACO
[The man] continues (picking pears)	CONTINUAR
while the dog jumped trying to reach the hive.	INDX B:cl.e(C):MADRIGUERA MIENTRAS B:cl.e(C):MADRIGUERA SN:PERRO B:cl.e(C):MADRIGUERA cl.e(Hd):PERRO-saltar+sobre-suelo cl.e(Bh):SUELO MENTE^OBJETIVO AVISPA cl.e(Hd):PERRO-saltar-localización cl.e(B):LOCALIZACIÓN
fills three (baskets) with the pears he picked from the tree.	LLENAR(MP) LLENAR(MP) LLENAR(MP)
and sat scared	cl.e(2d):PERSONA-sentarse-suelo cl.e(Bh):SUELO
The frog [its sign] was there	RANA INDX SN:rana HABER
and looks at (the baskets)	MIRAR
One of the youngsters carried a ball on a racket.	HOMBRE PERSONA UNO cl.m(Xc):accionar-raqueta
The seven of us will have to fight each other	INDX.PRO:1pl SIETE cl.e(1):PERSONA-enfrentarse-persona
It is ready	AHORA B:cl.c(1):PATAS-retroceder PREPARAR(1M) B:cl.c(1):PATAS-retroceder
a little less painful."	DOLOR MENOS(2M) G:prosódico
A man climbed up the tree (with a ladder)	HOMBRE PERSONA ÁRBOL cl.e(2d):PERSONA-ascender+a-árbol cl.e(5):ÁRBOL
We have come to the end	HASTA FIN
slaps him	G:manotazo
(The man) climbs up the ladder again	OTRA-VEZ(1M) cl.c(X):PIERNAs-ascender+por
(until there stands) an empty space.	VACÍO
(The pig) has just finished	INDX ARREGLAR LISTO
After loading the basket on the bike	BICICLETA cl.m(Xc):colocar-cesta-en+bicicleta cl.e(Bl):BICICLETA
and he was getting away.	ALEJARSE B:cl.m(Q):coger-sombrero
(there) were three	TRES
Can I start?	EMPEZAR
relaxed	EMOCIÓN RELAJAR
One night Kuma was at home sleeping	NOCHE DORMIR CASA
and placing them in his apron	cl.m(A&amp;gt;5d):echar-peras-mandil cl.e(B):MANDIL
and down there	MIRAR
The boy on the bicycle heard the whistle	BICICLETA OÍR cl.e(Xa):BICICLETA
What a fright! it was a deer	ASUSTAR(2M) cl.d(4):cornamenta-forma
"Child [his sign] come/down"	SN:niño VENIR2
and the frog looked at (them)	SN:RANA B:cl.e(C):FRASCO MIRAR SN:RANA
(That) the frog would bite her at night	RANA ANTES2 NOCHE G(X)(2M):maquinación
holds it	cl.m(5d):agarrar-fruta
looking for it	BUSCAR(2Msu)
He picked a pear and observed it carefully.	UNO B:cl.m(Cc&amp;gt;5d):echar-fruta cl.m(5d):coger-fruta cl.m(5d):examinar-fruta
to see that one of the three baskets	MIRAR B:cl.m(4d):agarrar-delantal LO-DE-ANTES B:cl.m(4d):agarrar-delantal TRES B:cl.m(4d):agarrar-delantal
The child called out (to the frog)	GRITAR2
and called out (to the wizard).	LLAMAR
There it was	INDX
The child jumps out the window	INDX HOMBRE SN:niño cl.e(2d):PERSONA-saltar+de-ventana cl.e(Bh):VENTANA
continues	G:prosigo
The last brother the third one says: "Relax".	HERMANO ÚLTIMO(1M) B:HERMANO B.L(3) INDX:tercero TRANQUILO
The boy continues to look around	HOMBRE MIRAR BÚHO^VOLAR
eat them	MORDER
looking for it	BUSCAR(2Msu)
and after blowing out all the air	cl.d(5):flujo-aire B:INTENTAR
"She is not here" they said astounded upon reach that point.	cl.c(I):PIE-pisar HABER-NO(2M) G:extrañeza
Another (personality is) the wolf which wants to eat (them)	OTRO LOBO LOBO MENTE^OBJETIVO MENTE^OBJETIVO COMER
The animal goes	cl.e(2d):ANIMAL-chocar cl.e(C):MADRIGUERA cl.e(2d):ANIMAL cl.e(C):MADRIGUERA
The deer gallops	RESPIRAR B:cl.e(5):ÁRBOL
"Brother brother!"	AVISAR AVISAR
Look.	VER
with a glass jar (in which was) a frog [its sign]	CRISTAL cl.d(C):frasco INDX cl.e(C):FRASCO SN:RANA B:cl.e(C):FRASCO
He was standing on something that was also moving (without knowing what it was)	cl.e(2b):PERSONA-sobre-entidad cl.e(1):ENTIDAD cl.m(A):agarrar-ramas G:¿Qué B:cl.m(A):agarrar-ramas
"Where could Arua be?" (they asked).	CUÁL SN:ARÚA DÓNDE(2M) CUÁL
(and) sees	DESCUBRIR
Kuma: "Wait wait."	ESPERAR2(2M)
I took her into my arms.	cl.m(5d):coger-persona
He looked back (at the baskets)	B:PODER3 B:DESAPARECER MIRAR B:DESAPARECER
He could face animals such as the tiger the puma and many more.	PODER CONTRA CONTRA ANIMAL2 G TIGRE cl.c(5d):garras-andar DL:PUMA ETC
He was playing with it without much enthusiasm.	cl.m(Xc):accionar-raqueta
into the distance	CAMINAR(MP)
[One of the three children] saw a hat.	cl.m(Q):coger-sombrero
to the place where there are bees	cl.e(C):FRASCO-descender
The boy on the bicycle also left	INDX ALEJARSE
(and) saw a man.	HABER B:ÁRBOL HOMBRE B:ÁRBOL INDX B:ÁRBOL G:efectivamente B:ÁRBOL
falls on the head of the deer	cl.e(2d):PERSONA-caer-cabeza
to her fate.	YA G:indiferencia MORIR(MP) ABANDONAR B
It is taking a long time (to build the house).	G(5):mucho G:mucho HORA DURAR
stopped	cl.e(2d):PERSONA-sentarse-suelo cl.e(Bh):SUELO
Kuma was a strong and courageous person	INDX.PRO:3sg PERSONA FUERTE DEPORTE G
Looks under the bed	CAMA cl.e(1):TRAIECTORIA-desplazarse-cama cl.e(Bh):CAMA
(but) not close (to it)	CERCA NO
The boy is running "Ahh!"	MIRAR cl.e(C):FRASCO-en-cabeza
see (him on the floor)	MIRAR
(What a disappointment)	G(5)(2M):chasco
This is impossible	IMPOSIBLE hhh
(The child asks) "Where is it?"	MIRAR B:DESAPARECER DÓNDE G(5)(2M):interrogativo
(Kuma) reflected on the words.	PENSAR(2Msu)
blows (strongly).	SOPLAR(2M)
even looked inside a boot.	HASTA BOTA cl.m(A):levantar-bota
The wolf comes nearer (quietly)	LOBO(1M) cl.c(B):pies-andar cl.c(B):pies-anda
"But how are you going to leave her (in the forest)?	G:extrañeza CÓMO G:interrogativo ARROJAR
He took it in his arms	cl.m(Bd):coger-perro
He touched them and they began to move.	cl.m(5&amp;gt;A):agarrar-ramas MOVER cl.m(A):agarrar-ramas
into the distance	HASTA cl.e(1):TRAIECTORIA-desplazarse
(The three) boys walk by.	HOMBRE cl.e(3):PERSONAS3-desplazarse
Help me please."	POR-FAVOR AYUDAR G
"I want to wait 	INDX.PRO:1sg QUERER ESPERAR2(2M)
(and) empties the pears from his apron.	cl.m(A&amp;gt;5):ARROJAR-peras cl.e:MANDIL
they approached	MIRAR(2M)
Years passed	TRANSCURRIR
put the pears in the basket (and)	PERA4(2M) ARROJAR(2Msu) cl.d(5):cesta LO-DE-ANTES B:cl.d(5):cesta ARROJAR(2Msu)
The trunk is near now	cl.e(2d):AVE-posarse-árbol cl.e(5):ÁRBOL
It is a deer	B:cl.e(1):PERSONA-desplazarse-con+perro B:cl.e(2d):PERRO-desplazarse-con+persona
"Blown down? Really?" (it asked the brother puzzled).	HERMANO B:HERMANO SOPLAR(2M) MIRA-TÚ
picks up a pear	cl.m(5d):coger-fruta
(approaches and) looks out the window	MIRAR VENTANA
and climbs on the roof	COCINAR
"Wait!"	ESPERAR2 B:cl.e(Xa):BICICLETA ESPERAR2 B:cl.e(Xa):BICICLETA
The house is shaken.	cl.e:CASA-moverse
"Shh! I've heard the frog it is there." 	ESCUCHAR B:G:perro INDX G:pausa G:pausa B:G:pausa SILENCIO B:G:pausa ESCUCHAR B:G:pausa HABER B:G:pausa SN:RANA B:G:pausa INDX B:G:pausa
(In an) orchard	cl.e(5):ÁRBOL-fila-suelo cl.e(Bh):SUELO
Then came another person a boy wearing a hat on a huge bike.	OTRO B:cl.e(B):SACO VENIR B:cl.e(B):SACO UNO B:cl.e(B):SACO HOMBRE B:cl.e(B):SACO PEQUEÑO2 B:cl.e(B):SACO CON SOMBRERO CON BICICLETA ENORME B: BICICLETA BICICLETA BICICLETA cl.m(A):agarrar-manillar
A hidden burrow. It approached the burrow and called: Frog!"	cl.d(1):madriguera-forma cl.e(C):MADRIGUERA cl.d(5):hierba-sobre-madriguera B:cl.e(C):MADRIGUERA cl.d(1):madriguera-forma B:cl.e(C):MADRIGUERA LLAMAR B:cl.e(C):MADRIGUERA GRITAR2 B:cl.e(C):MADRIGUERA
(there is) a man	HOMBRE PERSONA
and decided to pick her up.	G:pensar cl.m(5d&amp;gt;A):coger-persona
A dog whose sign is this [dog-ear]	OTRO PERRO SIGNO SN:PERRO
In a field between green mountains	PAISAJE VERDE B:PAISAJE cl.d(5):hierba-recubriendo-monte B:PAISAJE CAMPO cl.e(L):CAMPO-localización
The one made with bricks".	INDX CONSTRUIR MIRAR
"the house is there" (it calculates).	INDX cl.e:CASA
(It is making it) with bricks	CONSTRUIR
The boy had fallen	HOMBRE PEQUEÑO2 CAER
He began picking pears to pack into the sack he was carrying.	cl.m(5d&amp;gt;5):coger+guardar-fruta cl.e(B):SACO
until it breaks apart.	cl.e:CASA-desintegrarse
"Warning!: 	G B:ESCUCHAR(2M) AVISAR B:ESCUCHAR(2M)
(and) (the boy’s) hat fell off.	cl.e(Xa):sombrero-caer
(and was) riding (her bike)	BICICLETA
searched everywhere	MIRAR(2M)
The child on a bike yes him	INDX LO-DE-ANTES INDX BICICLETA ALEJARSE INDX
My seven children want to fight each other to death	INDX.PRO:3pl PROPIO(2M) SIETE HIJO QUERER MORIR(2Msu)
(the ones I mentioned) before	PASADO(2Msu) INDX
but it is very painful	ENTONCES DOLOR FUERTE
The dog looks at him from below without moving	cl.e(55):AVE-volar B:cl.e(55):AVE-volar cl.e(1):AVE-localización VOLAR
in the mean time wait."	ESPERAR2(2M)
(The wolf) continues blowing	cl.d(5):flujo-aire cl.d(5):suelo
The construction is solid" (said the third pig).	CONSTRUIR PIEDRA
and blows.	SOPLAR(2M)
Kuma: "Wait wait."	G:impresionado SN:KUMA G:impresionado
A long time ago in Central America in Nicaragua in that country.	PASADO(2Msu) CENTROAMÉRICA DÓNDE B:CENTROAMÉRICA SIGNO B:CENTROAMÉRICA NICARAGUA DL:NICARAGUA INDX.DEM PAÍS
The dog also peered	TAMBIÉN B:cl.e(Bh):TRONCO SN:PERRO B:cl.e(Bh):TRONCO cl.e(2d):PERRO-ascender+a-tronco cl.e(Bh):TRONCO
and does not move.	cl.e:CASA B:cl.e:CASA
When I saw (the child) I had felt sorry for her	PASADO MIRAR
its jaw gets dislocated.	CARA cl.e(Xa):MANDÍBULA-descender
He takes three (pears from the basket)	cl.m(5d):coger-peras TRES
"I have hurt my knee badly!"-he said in pain and began to rub it.	DOLOR B:cl.e(Bh):SUELO G:¡uuuy! B:cl.e(Bh):SUELO DOLOR B:cl.e(Bh):SUELO INDX cl.c(1):PIERNA G:frotarse-rodilla DOLOR cl.c(1):PIERNA FROTAR B:cl.c(1):PIERNA
It sniffs	PERRO B:BUSCAR(2Msu) cl.e(C):frasco B:cl.e(C):frasco
The owl glides towards the boy	cl.e(1):PERSONA cl.e(2d):PERRO B:cl.e(1):PERSONA cl.e(2d):PERRO
The boy and dog are looking astonished at the frog.	CIERVO cl.e(2b):PERSONA-sobre-cabeza+ciervo B:CIERVO
The man continued plucking pears.	cl.m(5d):coger+guardar-fruta cl.e(B):SACO
He looks up (into the tree)	MIRAR
The man was at the tree top	cl.e(2d):PERSONA-ascender+a-árbol cl.e(5):ÁRBOL
(There are only) two now...	DOS G:incomprensión
The two (were) looking (at the jar)	SN:NIÑO B:cl.e(C):FRASCO cl.e(1):PERSONA B:cl.e(C):FRASCO PERRO B:cl.e(C):FRASCO MIRAR(2M) MIRAR cl.e(C):FRASCO
"Now for the last and third house (to fall) for sure.	AHORA ÚLTIMO B.L(3) INDX:tercero ES.SEGURO(1M) B:INDX
with its snout inside	cl.c(A):cabeza-entrar-frasco cl.e(C):FRASCO
eating pears	PERA4(Xc) cl.m(5d):agarrar+comer-pera
(and starts) pedalling	BICICLETA
Looks up (at the man)	MIRAR
He continues working	TRABAJAR CONTINUAR
An owl comes out from within	RAPAZ^VOLAR cl.c(O):OJOS-acercarse
The dog (which is near) is also looking	PERRO SN:perro MIRAR
G	G:impotencia
empties the contents of the apron pocket in the basket	cl.m(5&amp;gt;A):coger-bolsillo cl.m(A):vaciar-bolsillo
and is stunned.	MENTE-APAGADA
"Kill Arua it should be better for you."	G:pausa INDX.PRO:2sg SN:ARÚA INDX.PRO:2sg BIEN INDX.PRO:3sg MORIR(MP) INDX.PRO:3sg
You will be called Arua."	INDX NOMBRE DL:ARUA
Looks inside a boot	BOTA MIRAR
Kuma: "Wait wait."	ESPERAR2(2M)
(because) the owl had besieged him	INDX RAPAZ^VOLAR cl.e(2d):BÚHO-acercarse
The child climbed up on a stone	INDX PIEDRA cl.d(5d):piedra cl.d(5d):piedra cl.e(2d):PERSONA-ascender+a-piedra cl.e(5d):PIEDRA
where its brother had entered.	LO-DE-ANTES HERMANO INDX DENTRO
 It is solid".	CASA FUERTE
The boy... the three boys approach (the blond boy)	INDX MUJER HOMBRE PEQUEÑO2 TRES cl.e(3):PERSONAS3-aproximarse
Kuma (continued to) think about the solution.	SOLUCIÓN PENSAR(2Msu)
"it hurts" (a lot...)	DOLOR G
and playing.	JUGAR
"This is weird! Very confusing!" He said unbelievingly	COMPLICADO POCO B:COMPLICADO COMPLICADO
The child and the dog slept until sunrise	INDX DORMIR(MP) HASTA DÍA
and swirl around	cl.e(Lc):AVISPAS-volar
and handed it over.	YA B:cl.m(Q):agarrar-sombrero cl.m(Q):dar-sombrero
"How can that be?"	cl.e(C):FRASCO G:incomprensión B:cl.e(C):FRASCO MENTE-APAGADA
and playing (with the frog)	JUGAR
(The wolf) takes a deep breath	RESPIRAR
until the ruminant stopped	cl.m(A):agarrar-cuernos
There was a village.	INDX.DEM PUEBLO
The three brothers... the two: "Look Up Up Up Up!"	VER TRES HERMANO hhh DOS VER INDX
which is in a glass jar	DENTRO CRISTAL2 cl.d(B):frasco-forma
It turns red from the effort	INTENTAR ROJO B:INTENTAR RUBOR B:INTENTAR
and	cl.m(Xc):accionar-raqueta
and a scarf on his neck	PAÑOLETA
The two brothers are trembling with fear	DOS HERMANO G(1d):miedo cl.c(1):PATAS-temblar MIEDO cl.c(1):PATAS-temblar
He looked at her spellbound.	MIRAR B:cl.m(A):agarrar-manillar BOBO B:cl.m(A):agarrar-manillar
cleans the pear with it	B:cl.m(5d):agarrar-fruta cl.m(E):limpiar-fruta
and very pretty	BONITO^MARAVILLA
and put it in the basket with care.	cl.m(4d):colocar-fruta cl.m(C):colocar-fruta PREPARAR LISTO
Climbs up...	cl.e(2d):PERSONA-ascender-árbol B:cl.e(5):ÁRBOL
and it licks his face	cl.c(B):LENGUA-lamer cl.m(C):sostener-perro
Whether she wants to marry or not.	SENTIR SÍ-O-NO INDX CASAR
and picking fruit	cl.m(5d&amp;gt;5):coger+guardar-fruta cl.e(B):SACO
and to get to the bottom... "Burning hot!" (shouts the wolf).	cl.e(2d):PERSONA-sobre-chimenea B:cl.e(C):CHIMENEA
"Brother	INDX LLAMAR INDX
The child hears something	INDX ESCUCHAR(2) INDX G(5):calma
(The dog) barks	GRITAR2
who was crying and	cl.c(5d):OJOS-llorosos
The seven looked for Arua around the place	BUSCAR(2Msu) cl.e(2):PERSONAS7-desplazarse cl.e(5):PERSONAS7-desplazarse G:hijo-buscando cl.e(2):PERSONAS7-desplazarse cl.e(5):PERSONAS7-desplazarse
They both look at (the third brother).	MIRAR(2M) DOS
(and) they leave.	ALEJARSE cl.m(Bd)sostener-peras
It was completely dark.	G:pensar-narrador OSCURO NEGRO G:prosódico
because a swarm starts to leave the hive	cl.d(5d):avispas-desplazarse
My house has been blown down	INDX.PRO:1sg PROPIO CASA ROMPER
puts it in the apron...	cl.m(5d):guardar-fruta B:cl.e(C):SACO
take [?]	COGER
It falls out the window	cl.e(2d):PERRO-caer+de-ventana cl.e(Bh):VENTANA
and puts his head inside	cl.m(B):apoyarse-tronco
(and decides) to return.	VOLVER
The boy cycled hooking his gaze (at the girl)	MIRAR
with Arua inside.	G:flor-cubrir-cabeza cl.e(Cc):FLOR-cerrada-persona cl.e(1):PERSONA
The house of straw bundles is already finished."	CASA PALO YA LISTO
You are working (very hard)" said the pig.	G:demasiado TRABAJAR
(while) walking	cl.e(1):PERSONA-alejarse
(The wolf) moves back.	cl.c(1):PATAS-retroceder
(but) she saw (nothing)	VER-MAL
with the deer gazing at him the boy is scared and leaps	INDX ÁRBOL(1M) cl.d(Qd&amp;gt;Q):colmena-en-árbol cl.e(5):ÁRBOL
There was a dark hole in a tree	INDX B:CONTINUAR ÁRBOL cl.d(1):hueco-forma cl.d(C):hueco-en-tronco OSCURO
He is in the middle of the river	cl.e(55):AVE-volar
will get married to Arua.	CASAR INDX.PRO:3sg SN:ARÚA G
The boy falls off the stag’s back into a river	cl.e(Hd):PERRO-girarse+hacia-árbol cl.e(5):ÁRBOL
blows (strongly).	SOPLAR
is surprised.	MENTE-APAGADA
"just one" (he thought)	INDX.LOC B:ÁRBOL UNO B:ÁRBOL B:UNO cl.m(5d):coger-fruta NO B:cl.m(5d):coger-fruta
I would like to ask her again to marry me"	QUERER DECIR OTRA-VEZ CASAR
and cycled away	B:cl.m(Xc):colocar-cesta LISTO
I could not understand how (this was possible)	SN:NIÑO B:cl.m(A):agarrar-cuernos MENTE^APAGAR cl.m(A):agarrar-cuernos MOTIVO B:cl.m(A):agarrar-cuernos cl.m(A):agarrar-cuernos
A girl happened to also pass by on a bike	CASUAL B:cl.m(A):agarrar-manillar MUJER B:cl.m(A):agarrar-manillar OTRO B:cl.m(A):agarrar-manillar BICICLETA
The boy climbs on the rock	cl.m(Bd):coger-perro
wearing a hat	cl.d(Xa):sombrero
and he had stood on its back!	cl.e(1):PERSONA-sobre-ciervo cl.m(A):agarrar-cuernos G:estupefacción B:cl.m(A):agarrar-cuernos
Let me explain.	INDX.PRO:1sg EXPLICAR
(when) the girl disappears into the distance.	MUJER ALEJARSE
The wolf climbs on the roof.	TREPAR cl.e(2d):PERSONA-ascender+a-casa cl.e:CASA
on two legs	BUSCAR
There in a row	cl.e(2d):RANAS-fila
(Arua) walked	CAMINAR(MP)
The third (brother): "I know	hhh B.L(3) INDX:tercero SABER
"Yes now it is coming (to your house)".	(CNM) AHORA TURNO
"Wait!"	ESPERAR2 B:cl.m(Q):coger-sombrero
They continued on their way	TRES cl.e(3):PERSONAS3-desplazarse
but he continued pedalling without taking his eyes off her	cl.m(A):agarrar-manillar
unties his scarf	cl.m(5d):agarrar-fruta cl.m(Xc):desatar-pañoleta
They run to the bottom of a slope	cl.e(Lc):INSECTO-volar B:cl.e(5):ÁRBOL
(and starts) pedalling	BICICLETA
The boy escapes	cl.e(2d):PERRO-caer+de-ventana cl.e(Bh):VENTANA
while the child galloped on the back of the deer	SN:NIÑO cl.e(2d):PERSONA-botar-ciervo cl.e(Bh):CIERVO cl.c(A):pezuñas-correr
There is a wooden house	HABER CASA MADERA
There were a few foot prints in the ground	cl.c(I):PIE-pisar LO-DE-ANTES
(and) scattered on the floor.	DIFUNDIR
(He was walking) with a goat	CON CABRA
The two... three of them are siblings.	LOS-DOS LOS-TRES TAMBIÉN HERMANO LOS-TRES
The bike (is) lying (on the floor)	BICICLETA cl.d(Xa):bicicleta-en-suelo
he kneels	cl.e(2b&amp;gt;2d):PERSONA-arrodillarse-suelo cl.e(5):SUELO
as they approached  it	B CERCA
(One) to the house of b... bundles of straw and enters	OBJETIVO CASA MADERA PALO DENTRO YA
and the boy flew out.	cl.e(2b):PERSONA-caer+de-ciervo cl.e(Bh):CIERVO
(The boy got injured) when he fell	cl.e(2b):PERSONA-caer-suelo cl.e(Bh):SUELO SUFRIR B:cl.e(Bh):SUELO
He uprights the bike	BICICLETA cl.m(A):levantar-bicicleta
And he called out frog.	VENTANA GRITAR2 B:VENTANA LLAMAR B:VENTANA
Arua was alone (and scared).	SOLO2 SN:ARÚA SOLO2
(but) when they got up	G:niño-se-levanta
The boy that fled on the bicycle	cl.m(A):agarrar-manillar
(The one with the racquet) continues to play with the ball	cl.m(Xc):accionar-raqueta
(and it) was night	FECHA SITUACIÓN NOCHE
Nothing (happens)	cl.e:CASA
(and) was plucking pears from different branches	cl.m(5d&amp;gt;5):coger+guardar-fruta cl.e(B):SACO
and left.	ALEJARSE
[something] went wrong	FALLO
stares	PERRO B:cl.e(1):PERSONA-correr cl.e(Hd):PERRO-correr-persona+detrás cl.e(1):PERSONA-correr-perro+delante
The wolf continues.	LOBO CONTINUAR
The house is finished.	YA CASA LISTO
(then) place the basket (on the bike)	INDX cl.m(C):colocar-cesta
(Strange he thought) I had left it here...	G:incomprensión INDX.PRO:1sg LO-DE-ANTES VERDAD2 INDX.PRO:1sg G:incomprensión
in the window	MIRAR VENTANA
"What?	CUÁL
Three children on foot (come by).	HOMBRE cl.e(3):PERSONAS3-aproximarse
Three children came by	HOMBRE cl.e(3):PERSONAS3 PEQUEÑO2
An owl a nocturnal bird with large eyes flew out the hole and scared him	ASUSTAR B:cl.m(5):apoyarse-en+tronco cl.e(Q):CABEZA+ANIMAL-ascender B:cl.m(5):apoyarse-en+tronco RAPAZ^VOLAR cl.d(Xa):ojos-grandes NOCHE
as the flower closed completely around her.	cl.d(5):flor-cubrir-Arúa cl.e(5d&amp;gt;Cc):FLOR-cerrarse-persona cl.e(1):PERSONA
he climbed down the tree	cl.e(2d):PERSONA-descender+de-árbol cl.e(5):ÁRBOL LISTO(1M) B:cl.e(5):ÁRBOL
I am going to explain.	EMPEZAR INDX EXPLICAR
The dog barks	PERRO B:B:cl.d(5):agua-superficie G:perro
There was nothing.	HABER-NO
"the hat"	cl.m(Q):elevar-sombrero
He (continues) working	CONSTRUIR
The two of them walk	SALPICAR cl.e(Xa):ONDA-abrirse
The dog gets up	INDX PERRO cl.c(Bg):orejas
on a bike	INDX BICICLETA
this was a pear tree.	QUÉ TIPO PERA
He placed his hands (on the ground)	cl.m(5):apoyarse-árbol
The one who wins	UNO VICTORIA
The earlier man	HOMBRE PERSONA LO-DE-ANTES cl.e(2d):PERSONA-en-árbol cl.e(5):ÁRBOL
The three youngsters walked away	ALEJARSE B:ASÍ TRES B:ASÍ cl.e(3):PERSONAS3-alejarse B:ASÍ
it was clear.	G:
On  his left he sees a trunk	cl.e(1):PERSONA-desplazarse cl.c(B):garras-correr CORRER B:CORRER cl.e(1):PERSONA-correr
He walked past with the goat on a leash	cl.m(Xc):agarrar-correa
Then the child [with this sign] is facing the frog [whose sign is]	ENTONCES HOMBRE PEQUEÑO2 SN:niño MIRAR RANA SN:rana
takes a pear	G:hombre cl.m(Q):coger-fruta
with a pocket	hhh cl.d(L&amp;gt;B):bolsillo-delantal
The man followed them with his eyes	HOMBRE MIRAR
when a pear fell rolling outside the sack.	UNO B:cl.e(B):SACO MANZ- B:cl.e(B):SACO PERA2 B:cl.e(B):SACO cl.e(Cc):FRUTA-caer+de-saco B:cl.e(B):SACO
and caresses it	cl.e(2b):PERSONA-descender+de-cama cl.e(Bh):CAMA
plucks another pear	cl.m(5d):arrancar-fruta B:cl.e(C):SACO
(The man continues) plucking pears	cl.m(5d):coger+echar-fruta-en+saco cl.e(5h):SACO
falls on the head of the deer	ABEJA B:cl.e(5):ÁRBOL cl.e(Lc):INSECTO-volar-árbol B:cl.e(5):ÁRBOL
lay  a tree.	ÁRBOL cl.e(5):ÁRBOL
(The child begins to) worry	PROBLEMA
[the pears].	COGER(2Msu)
Where (could the frog be)?	DÓNDE
and they are about to cross each other	cl.e(Xa):BICICLETA-aproximarse-bicicleta
If another [child] appeared in the future I would (likewise) take it in..	FUTURO OTRO cl.m(5d):coger-persona MENTE G:interrogativo
She looked around	MIRAR B
when suddenly he sees the dog	G:mmm G:mmm
(her) sign "Star".	SIGNO SN:ARÚA INDX.PRO
because the glass jar had shattered on the floor.	MOTIVO B:cl.m(Bd):coger-perro CRISTAL B:cl.m(Bd):coger-perro GRIETA B:cl.m(Bd):coger-perro ROMPER cl.d(5h):esparcirse-añicos B:ROMPER
The pears fell	PERA4(Xc) cl.d(A&amp;gt;5):peras-caer
he kneels on the ground	AHORA cl.e(2b&amp;gt;2d):PERSONA-arrodillarse-suelo cl.e(5):SUELO
And the bottle with the snout falls to the ground	cl.e(C):FRASCO-descender
her and kill her.	ANIQUILAR G:prosódico
"I don't understand	LOBO MENTE^APAGAR
He took it in his hands and looked to see if it was clean	COGER cl.m(5d):examinar-fruta PURO cl.m(5d):agarrar-fruta
(began to) flit around the flower	cl.e(55):MARIPOSA-volar
 The wolf comes!" (the pigs scream).	VENIR B:ESCUCHAR(2M) LOBO YA
(She has two) braids	TRENZA TRENZA
the one who wins in strength and skills will marry Arua".	VICTORIA FUERTE DEPORTE INDX.PRO:3sg COGER CASAR INDX SN:ARÚA
and now what?	G:evidencia CÓMO FIN CUÁL G:pausa
that had fallen to the ground	cl.d(Q):sombrero-caído
Arua and Kuma’s boys grew up together.	CRECER(2M) PEQUEÑO2(2M) CRECER(2M)
The dog [his sign] sees them	G(Bd)(2M):ilativo SN:perro MIRAR
The man walking the goat	HOMBRE PASEAR CON CABRA
The three boys go away	cl.e(3):PERSONAS3-alejarse
and looked inside.	cl.m(5):apoyarse-en+tronco
I think so.	PARECER(2M)
"Frog! You Frog!"	GRITAR2
and quickly goes up the fireplace	G(5 2M):descender-por-interior-chimenea G:descender-por-interior-chimenea
and turned to see where it came from	MIRAR B:cl.e(Xa):BICICLETA
looking from inside the bottle	cl.e(2d):RANA-saltar+de-frasco B:cl.e(C):FRASCO
the forgotten hat	OLVIDAR SU(1M) SOMBRERO
and they crashed	INDX BATALLA
I sensed it.	OLER
Kuma looked at her and	SN:KUMA MIRAR
I am going to narrate (a story) about pears	TEMA PERA4(Xc) DL:PERA
The house had not moved.	cl.e:CASA
The father (stayed) thinking.	PADRE PENSAR(2Msu) G:resulución
and walked (terrified)	CAMINAR(MP)
Where is it?"	DÓNDE
The forest became darker	OSCURO BOSQUE
(The youngsters) went away	ALEJARSE G:mano-en-cintura G:¡qué-raro! B:G:mano-en-cintura
The boy starts to walk with the frog in his hand	cl.c(A):pezuñas-frenar
Now it is finished	AHORA LISTO
while she looked at the flower.	MIRAR FLOR MIRAR
He looked (at the man at the tree top and decided).	MIRAR B:CESTO G:incumplimiento B:CESTO
pedalling	BICICLETA
And walked stealthily	cl.c(X):PATAS-andar
The boy continued searching.	SN:NIÑO CONTINUAR BUSCAR B:CONTINUAR
Kuma took Arua home and looked after her.	CUIDAR
The dog is (next to the child)	PERRO MIRAR
and it licked his face	cl.c(B):LENGUA-lamer B:cl.m(Bd):coger-perro
Who knows!	G:quién-sabe
(The boy with the racquet) looks at the blond boy in the distance	MIRAR RUBIO cl.e(1):PERSONA
Let’s see how  the third and final pig (is building its) house.	VER ÚLTIMO B.L(3) INDX:tercero INDX CÓMO CASA CÓMO
Are you sure?	ES.SEGURO(1M)
The pig (responds): "I know I know.	HOMBRE- CERDO SABER INDX
It prepares itself:	PREPARAR
She couldn't (walk any more).	PODER2 B
(All) jumping.	cl.e(Hd):RANAS-saltar RANA
(And started) to search.	BUSCAR(2Msu)
learning on the tree trunk.	cl.e(2b):PERSONA-apoyarse-tronco cl.e(B):TRONCO
(The wolf) fills its lungs (with air)	cl.d(5):pecho-hinchar
and escapes steaming.	cl.e(2d):PERSONA-descender+por-chimenea cl.e(C):CHIMENEA LLAMA B:cl.e(C):CHIMENEA
A dog sitting opposite	HABITACIÓN CAMA HOMBRE cl.e(2d):PERSONA-sentada
I need your advice.	CÓMO ACONSEJAR G
Those three children who are coming	INDX cl.e(3):PERSONAS3-desplazarse
When I think about it	FUTURO PENSAR(2Msu)
it looks carefully	B:ACOSTARSE PERRO cl.e(Bh):CAMA cl.e(2d):PERRO-ascender+a-cama cl.e:CAMA cl.e(2d):PERRO-posarse-cama
then takes the...	cl.m(5):coger-cesta
(The wolf takes) a look (at the house)	G:concentración MIRAR
It goes near (the house)	AHORA cl.c(1):PATAS-andar
climbs on the bike	cl.e(2b):PERSONA-ascender+a-bicicleta cl.e(B):BICICLETA
The two rushed	LOS-DOS B:cl.e(Bh):CIERVO cl.e(2d):PERSONA-caer-con+perro cl.e(2d):PERRO-caer-con+persona